season,team_1,team_2,home,seed_diff,score_diff,score_1,score_2,won,pred
1985,288,73,0,-3,-9,41,50,0,-3.60145230960554
1985,5929,73,0,4,6,61,55,1,0.474164250835699
1985,9884,73,0,5,-4,59,63,0,-0.414316413973896
1985,73,288,0,3,9,50,41,1,3.60145230960642
1985,3920,410,0,1,-9,54,63,0,8.1761792235749
1985,8405,410,0,8,3,68,65,1,8.22865178085939
1985,4149,513,0,8,-2,64,66,0,0.824334430413092
1985,6281,513,0,9,6,62,56,1,4.69569691039951
1985,7201,513,0,5,-1,58,59,0,2.81975058204478
1985,2340,764,0,8,-1,73,74,0,8.64976873480068
1985,5077,764,0,9,2,59,57,1,5.47369075460679
1985,8984,764,0,5,-2,53,55,0,0.00318103851371987
1985,10020,2082,0,1,2,51,49,1,0.81736969253687
1985,8662,2204,0,3,5,70,65,1,-0.0521058554359222
1985,764,2340,0,-8,1,74,73,1,-8.6497687347965
1985,6966,2340,0,-11,-13,62,75,0,-15.4569442196502
1985,5212,2675,0,15,4,59,55,1,25.6531467497066
1985,3234,3132,0,-1,-6,54,60,0,-4.03816474728386
1985,4400,3132,0,-15,-25,43,68,0,-32.8650384489034
1985,4698,3132,0,-3,-12,53,65,0,-10.070142146612
1985,8405,3132,0,0,-18,59,77,0,-2.77533700641986
1985,8746,3132,0,-7,-17,46,63,0,-13.0627357050169
1985,10020,3132,0,-7,2,66,64,1,-10.3241388733348
1985,3745,3166,0,3,16,74,58,1,2.73493060901902
1985,10564,3166,0,-5,-8,59,67,0,-6.95895337307276
1985,3132,3234,0,1,6,60,54,1,4.03816474727991
1985,3745,3234,0,-1,-8,53,61,0,2.73140409898349
1985,5111,3234,0,-13,-7,58,65,0,-16.4310045781344
1985,8662,3234,0,-5,-17,53,70,0,-4.22998722519264
1985,3166,3745,0,-3,-16,58,74,0,-2.73493060902144
1985,3234,3745,0,1,8,61,53,1,-2.73140409898772
1985,6372,3745,0,-11,-19,57,76,0,-16.5746836283454
1985,6664,3779,0,8,6,75,69,1,10.3234513804647
1985,9663,3779,0,1,-3,55,58,0,0.0478401664160071
1985,4698,3886,0,9,1,59,58,1,7.48974251937731
1985,410,3920,0,-1,9,63,54,1,-8.17617922358152
1985,6629,3954,0,9,11,75,64,1,3.64063479193422
1985,513,4149,0,-8,2,66,64,1,-0.824334430411117
1985,6595,4149,0,-11,-11,38,49,0,-6.96990125276494
1985,8405,4264,0,11,16,86,70,1,5.67348626864197
1985,9629,4264,0,8,-3,61,64,0,-2.33379995472935
1985,10366,4264,0,7,-8,58,66,0,0.167065193667611
1985,3132,4400,0,15,25,68,43,1,32.8650384488983
1985,6629,4562,0,1,-12,67,79,0,3.42029740032525
1985,6664,4562,0,4,2,86,84,1,9.26129168852032
1985,7000,4562,0,-7,-24,54,78,0,-2.20484734151724
1985,3132,4698,0,3,12,65,53,1,10.0701421466077
1985,3886,4698,0,-9,-1,58,59,0,-7.48974251937528
1985,8059,4698,0,-1,-13,57,70,0,1.51666795489523
1985,5850,4732,0,-9,23,78,55,1,-7.51188568615877
1985,9884,4907,0,13,16,81,65,1,12.3642896721538
1985,5178,4941,0,-7,-1,68,69,0,-7.84057344525641
1985,5850,4941,0,-8,-5,59,64,0,-8.69964601212903
1985,10020,4941,0,-3,3,46,43,1,-4.42956443319643
1985,764,5077,0,-9,-2,57,59,0,-5.4736907546063
1985,6664,5077,0,1,-2,61,63,0,3.20745517331939
1985,6898,5077,0,-13,-12,55,67,0,-19.8596168901728
1985,9269,5077,0,-5,-1,66,67,0,-6.7957417100431
1985,10020,5077,0,-6,7,52,45,1,-5.70374754689354
1985,3234,5111,0,13,7,65,58,1,16.4310045781331
1985,4941,5178,0,7,1,69,68,1,7.84057344525365
1985,2675,5212,0,-15,-4,55,59,0,-25.6531467497046
1985,10020,5212,0,-7,4,59,55,1,-9.95624308597233
1985,9269,5246,0,3,2,70,68,1,-5.30419268327007
1985,6281,5715,0,13,19,76,57,1,18.2979863537788
1985,4732,5850,0,9,-23,55,78,0,7.51188568615904
1985,4941,5850,0,8,5,64,59,1,8.69964601212829
1985,6664,5884,0,15,13,96,83,1,25.8177755512627
1985,73,5929,0,-4,-6,55,61,0,-0.474164250834459
1985,6012,5929,0,-11,-9,56,65,0,-11.3373925557774
1985,8405,5929,0,2,9,69,60,1,2.41538426129904
1985,9847,5929,0,-8,-13,73,86,0,-7.00417925426651
1985,5929,6012,0,11,9,65,56,1,11.3373925557738
1985,513,6281,0,-9,-6,56,62,0,-4.69569691039294
1985,5715,6281,0,-13,-19,57,76,0,-18.2979863537775
1985,6542,6281,0,-5,-2,58,60,0,-5.49148848023632
1985,10020,6281,0,-6,12,56,44,1,-6.01561914512503
1985,3745,6372,0,11,19,76,57,1,16.574683628341
1985,6281,6542,0,5,2,60,58,1,5.4914884802384
1985,6830,6542,0,-3,-9,70,79,0,-2.05920380978134
1985,4149,6595,0,11,11,49,38,1,6.96990125276355
1985,3954,6629,0,-9,-11,64,75,0,-3.64063479193563
1985,4562,6629,0,-1,12,79,67,1,-3.4202974003308
1985,3779,6664,0,-8,-6,69,75,0,-10.3234513804658
1985,4562,6664,0,-4,-2,84,86,0,-9.26129168852303
1985,5077,6664,0,-1,2,63,61,1,-3.20745517332041
1985,5884,6664,0,-15,-13,83,96,0,-25.8177755512626
1985,8059,6732,0,7,17,85,68,1,3.99300560669048
1985,6542,6830,0,3,9,79,70,1,2.05920380978317
1985,5077,6898,0,13,12,67,55,1,19.8596168901721
1985,2340,6966,0,11,13,75,62,1,15.4569442196543
1985,4562,7000,0,7,24,78,54,1,2.20484734151508
1985,513,7201,0,-5,1,59,58,1,-2.81975058204052
1985,9629,7693,0,9,5,85,80,1,2.41078193160003
1985,4698,8059,0,1,13,70,57,1,-1.51666795489605
1985,6732,8059,0,-7,-17,68,85,0,-3.99300560669134
1985,8405,8239,0,15,24,83,59,1,16.8550707981354
1985,410,8405,0,-8,-3,65,68,0,-8.22865178086492
1985,3132,8405,0,0,18,77,59,1,2.77533700641484
1985,4264,8405,0,-11,-16,70,86,0,-5.67348626864036
1985,5929,8405,0,-2,-9,60,69,0,-2.41538426130131
1985,8239,8405,0,-15,-24,59,83,0,-16.8550707981353
1985,2204,8662,0,-3,-5,65,70,0,0.0521058554377021
1985,3234,8662,0,5,17,70,53,1,4.22998722519407
1985,3132,8746,0,7,17,63,46,1,13.0627357050134
1985,10088,8746,0,-1,-3,57,60,0,7.08205165287446
1985,764,8984,0,-5,2,55,53,1,-0.00318103851122231
1985,9847,9167,0,-5,4,79,75,1,-3.50920246863702
1985,5077,9269,0,5,1,67,66,1,6.79574171004275
1985,5246,9269,0,-3,-2,68,70,0,5.30419268326908
1985,4264,9629,0,-8,3,64,61,1,2.33379995473185
1985,7693,9629,0,-9,-5,80,85,0,-2.41078193159915
1985,3779,9663,0,-1,3,58,55,1,-0.0478401664169681
1985,5929,9847,0,8,13,86,73,1,7.00417925426477
1985,9167,9847,0,5,-4,75,79,0,3.50920246863778
1985,73,9884,0,-5,4,63,59,1,0.414316413977865
1985,4907,9884,0,-13,-16,65,81,0,-12.3642896721546
1985,2082,10020,0,-1,-2,49,51,0,-0.817369692541192
1985,3132,10020,0,7,-2,64,66,0,10.3241388733296
1985,4941,10020,0,3,-3,43,46,0,4.42956443319412
1985,5077,10020,0,6,-7,45,52,0,5.70374754689216
1985,5212,10020,0,7,-4,55,59,0,9.95624308597276
1985,6281,10020,0,6,-12,44,56,0,6.01561914512624
1985,8746,10088,0,1,3,60,57,1,-7.08205165287285
1985,4264,10366,0,-7,8,66,58,1,-0.167065193665145
1985,3166,10564,0,5,8,67,59,1,6.95895337307555
1986,5213,40,0,13,6,70,64,1,23.8028792432579
1986,3746,74,0,1,-2,56,58,0,4.78642563248575
1986,4265,74,0,4,5,68,63,1,5.87377474771594
1986,10787,74,0,-7,-17,80,97,0,-7.26453712503877
1986,514,289,0,1,10,73,63,1,3.81005674015986
1986,5930,357,0,8,14,80,66,1,17.0184858676843
1986,6543,357,0,11,-7,83,90,0,18.3666537125945
1986,289,514,0,-1,-10,63,73,0,-3.81005674015468
1986,4597,514,0,6,8,84,76,1,6.07449595158666
1986,8406,514,0,7,-16,65,81,0,4.3368478392011
1986,9630,514,0,4,-7,63,70,0,0.539847184770409
1986,5078,589,0,11,32,95,63,1,18.714733843423
1986,4597,867,0,5,14,82,68,1,10.1458544043805
1986,9848,867,0,-3,-18,65,83,0,-1.77958144887477
1986,8663,909,0,13,49,101,52,1,28.979758956142
1986,3819,1551,0,11,-4,79,83,0,6.25492681693387
1986,5851,1551,0,7,1,71,70,1,-0.242272992571944
1986,8440,1551,0,8,-6,69,75,0,-5.31912117339282
1986,4265,2049,0,15,20,75,55,1,21.6110127793377
1986,2341,2205,0,11,7,74,67,1,12.3906293879114
1986,6665,2205,0,8,-5,69,74,0,8.58051445835991
1986,10055,2205,0,7,-4,68,72,0,5.4570002486901
1986,4597,2307,0,13,20,93,73,1,27.7363862359685
1986,2205,2341,0,-11,-7,67,74,0,-12.390629387909
1986,4150,2341,0,0,-4,67,71,0,0.599355591545951
1986,4597,2341,0,-1,3,72,69,1,-2.62598677159418
1986,5652,2341,0,-15,-7,78,85,0,-29.0714859639557
1986,5851,2341,0,-6,-21,50,71,0,-9.68746955721943
1986,6733,2341,0,-7,-28,61,89,0,-12.196323902113
1986,3746,2710,0,9,24,75,51,1,24.4459444189669
1986,5247,3133,0,-1,12,80,68,1,1.998905477807
1986,8985,3133,0,-9,-6,64,70,0,-14.5945429550035
1986,4733,3235,0,-9,6,70,64,1,-9.32966904921589
1986,4840,3235,0,-13,-15,53,68,0,-31.3077328313616
1986,10021,3235,0,-8,-5,61,66,0,-14.2880337149936
1986,74,3746,0,-1,2,58,56,1,-4.78642563248925
1986,2710,3746,0,-9,-24,51,75,0,-24.4459444189645
1986,1551,3819,0,-11,4,83,79,1,-6.25492681692997
1986,5930,3921,0,5,2,66,64,1,1.01877187354567
1986,5179,3955,0,-3,-2,79,81,0,-7.21001845589439
1986,5213,3955,0,5,-3,69,72,0,8.58850687943425
1986,5930,3955,0,1,4,70,66,1,2.80296428641962
1986,8747,4059,0,-1,11,61,50,1,-1.54332297488388
1986,2341,4150,0,0,4,71,67,1,-0.599355591539236
1986,5247,4150,0,-4,-10,86,96,0,-2.75672415737468
1986,5885,4150,0,-15,-25,46,71,0,-31.1651491719041
1986,5930,4150,0,-5,-8,67,75,0,-5.76172049694777
1986,8747,4150,0,-8,-22,43,65,0,-13.6713923312553
1986,74,4265,0,-4,-5,63,68,0,-5.87377474772718
1986,2049,4265,0,-15,-20,55,75,0,-21.6110127793434
1986,4733,4265,0,-10,2,59,57,1,-7.9996330044996
1986,10225,4265,0,-7,-7,64,71,0,-11.3234271135555
1986,514,4597,0,-6,-8,76,84,0,-6.07449595158811
1986,867,4597,0,-5,-14,68,82,0,-10.1458544043803
1986,2307,4597,0,-13,-20,73,93,0,-27.7363862359713
1986,2341,4597,0,1,-3,69,72,0,2.62598677159416
1986,4733,4597,0,-9,-11,77,88,0,-5.8461428629728
1986,6282,4597,0,-1,-15,79,94,0,7.51127227854244
1986,3235,4733,0,9,-6,64,70,0,9.32966904921327
1986,4265,4733,0,10,-2,57,59,0,7.99963300449265
1986,4597,4733,0,9,11,88,77,1,5.84614286296958
1986,5078,4733,0,8,-2,81,83,0,5.3342954165377
1986,7202,4733,0,5,-7,87,94,0,2.33729866945176
1986,3235,4840,0,13,15,68,53,1,31.3077328313594
1986,6967,4942,0,-7,-5,64,69,0,-7.29108501488088
1986,9630,4942,0,1,6,70,64,1,-1.47009427015097
1986,589,5078,0,-11,-32,63,95,0,-18.7147338434204
1986,4733,5078,0,-8,2,83,81,1,-5.33429541653779
1986,3955,5179,0,3,2,81,79,1,7.21001845589437
1986,40,5213,0,-13,-6,64,70,0,-23.8028792432604
1986,3955,5213,0,-5,3,72,69,1,-8.58850687943687
1986,3133,5247,0,1,-12,68,80,0,-1.99890547780082
1986,4150,5247,0,4,10,96,86,1,2.75672415738097
1986,10367,5247,0,-7,-2,70,72,0,-12.1332746239619
1986,9270,5383,0,5,2,66,64,1,1.02521009506089
1986,8406,5548,0,15,9,83,74,1,17.4769347196641
1986,2341,5652,0,15,7,85,78,1,29.0714859639579
1986,1551,5851,0,-7,-1,70,71,0,0.242272992572918
1986,2341,5851,0,6,21,71,50,1,9.6874695572232
1986,8663,5851,0,5,-12,85,97,0,9.29621702223375
1986,9168,5851,0,-3,-19,68,87,0,-1.93323649664496
1986,4150,5885,0,15,25,71,46,1,31.1651491719085
1986,357,5930,0,-8,-14,66,80,0,-17.0184858676877
1986,3921,5930,0,-5,-2,64,66,0,-1.01877187354559
1986,3955,5930,0,-1,-4,66,70,0,-2.80296428641734
1986,4150,5930,0,5,8,75,67,1,5.76172049695368
1986,10225,5979,0,1,8,67,59,1,-1.22011873256683
1986,4597,6282,0,1,15,94,79,1,-7.51127227854889
1986,9270,6282,0,-3,-18,59,77,0,-13.58355543891
1986,9766,6282,0,-11,-12,72,84,0,-23.5105613524584
1986,6665,6373,0,9,6,80,74,1,15.2008978182436
1986,357,6543,0,-11,7,90,83,1,-18.3666537126004
1986,2205,6665,0,-8,5,74,69,1,-8.58051445836128
1986,6373,6665,0,-9,-6,74,80,0,-15.200897818245
1986,2341,6733,0,7,28,89,61,1,12.1963239021164
1986,10469,6733,0,-1,-8,64,72,0,-2.44326131832146
1986,4942,6967,0,7,5,69,64,1,7.29108501488235
1986,4733,7202,0,-5,7,94,87,1,-2.33729866945196
1986,8440,7358,0,5,1,60,59,1,-0.537673699753281
1986,514,8406,0,-7,16,81,65,1,-4.33684783919972
1986,5548,8406,0,-15,-9,74,83,0,-17.4769347196626
1986,1551,8440,0,-8,6,75,69,1,5.31912117339198
1986,7358,8440,0,-5,-1,59,60,0,0.537673699753132
1986,909,8663,0,-13,-49,52,101,0,-28.979758956144
1986,5851,8663,0,-5,12,97,85,1,-9.29621702223261
1986,4059,8747,0,1,-11,50,61,0,1.54332297488813
1986,4150,8747,0,8,22,65,43,1,13.6713923312603
1986,3133,8985,0,9,6,70,64,1,14.594542955008
1986,5851,9168,0,3,19,87,68,1,1.93323649664523
1986,5383,9270,0,-5,-2,64,66,0,-1.02521009506146
1986,6282,9270,0,3,18,77,59,1,13.5835554389053
1986,9630,9471,0,9,23,74,51,1,9.0577997806343
1986,514,9630,0,-4,7,70,63,1,-0.539847184770213
1986,4942,9630,0,-1,-6,64,70,0,1.4700942701526
1986,9471,9630,0,-9,-23,51,74,0,-9.05779978063511
1986,6282,9766,0,11,12,84,72,1,23.5105613524547
1986,867,9848,0,3,18,83,65,1,1.77958144887638
1986,3235,10021,0,8,5,66,61,1,14.2880337149922
1986,10089,10021,0,3,-9,62,71,0,2.67589565362285
1986,2205,10055,0,-7,4,72,68,1,-5.45700024869053
1986,10021,10089,0,-3,9,71,62,1,-2.67589565362286
1986,4265,10225,0,7,7,71,64,1,11.32342711355
1986,5979,10225,0,-1,-8,59,67,0,1.22011873256683
1986,5247,10367,0,7,2,72,70,1,12.1332746239641
1986,6733,10469,0,1,8,72,64,1,2.44326131832212
1986,74,10787,0,7,17,97,80,1,7.2645371250325
1987,5886,75,0,-13,-17,71,88,0,-20.7839564525319
1987,6150,75,0,-5,-25,76,101,0,-8.32751507668928
1987,7169,75,0,-4,21,103,82,1,-5.87658846319188
1987,9849,290,0,3,7,98,91,1,-3.95962745702069
1987,3820,515,0,7,17,107,90,1,5.65997885650899
1987,7661,515,0,-1,-1,61,62,0,-6.00638440427278
1987,3747,556,0,11,-1,67,68,0,17.151763630935
1987,7169,556,0,8,3,90,87,1,12.5790560092635
1987,3134,954,0,15,22,75,53,1,23.5341790577173
1987,6150,1049,0,3,4,83,79,1,2.17113136061863
1987,9404,1083,0,9,19,92,73,1,6.88462267544985
1987,5447,1518,0,-9,5,65,60,1,-8.09326265492502
1987,4564,2206,0,-11,-14,62,76,0,-9.06114891436864
1987,4734,2206,0,-7,5,63,58,1,-5.25387617935868
1987,8407,2206,0,-3,-8,75,83,0,-3.10258906682898
1987,3820,2342,0,4,6,88,82,1,2.3161342841419
1987,8918,2342,0,-7,-7,51,58,0,-12.5393376077999
1987,10788,2342,0,-8,-5,60,65,0,-17.0889153051139
1987,3820,2711,0,15,34,92,58,1,23.9838641677843
1987,5931,2781,0,-5,-12,70,82,0,-8.68747786982591
1987,7203,2781,0,3,-19,66,85,0,-1.2060081147552
1987,8664,2781,0,4,6,87,81,1,-3.22775718754535
1987,8664,3050,0,13,6,79,73,1,22.2488130673134
1987,954,3134,0,-15,-22,53,75,0,-23.5341790577139
1987,4151,3134,0,-4,-13,57,70,0,-3.98637719890868
1987,6631,3134,0,-8,-3,79,82,0,-2.82337886215403
1987,7169,3134,0,-5,15,88,73,1,-3.1170665251815
1987,4185,3168,0,-1,3,82,79,1,-1.11230536608688
1987,4734,3236,0,-3,6,85,79,1,-0.700506674793225
1987,4151,3561,0,7,11,66,55,1,0.883426928993707
1987,9631,3679,0,15,25,95,70,1,24.2998599554541
1987,556,3747,0,-11,1,68,67,1,-17.1517636309342
1987,515,3820,0,-7,-17,90,107,0,-5.65997885650775
1987,2342,3820,0,-4,-6,82,88,0,-2.31613428414219
1987,2711,3820,0,-15,-34,58,92,0,-23.9838641677883
1987,4734,3820,0,-9,-1,76,77,0,-9.08818166381316
1987,8664,3820,0,-1,-1,73,74,0,-3.23503916401734
1987,9631,3820,0,0,-4,93,97,0,3.1261684174504
1987,6666,3922,0,-4,-2,91,93,0,-4.23109923299434
1987,7830,3922,0,-13,-23,76,99,0,-17.6132775586369
1987,9631,3922,0,1,3,84,81,1,2.46348431273007
1987,9849,3922,0,-5,-2,82,84,0,-10.649683460327
1987,3134,4151,0,4,13,70,57,1,3.98637719891114
1987,3561,4151,0,-7,-11,55,66,0,-0.883426928992375
1987,5447,4151,0,-8,-4,63,67,0,-4.15443681569411
1987,3168,4185,0,1,-3,79,82,0,1.11230536608918
1987,9631,4185,0,8,19,80,61,1,12.7390327108089
1987,6631,4266,0,-1,14,91,77,1,2.60661164296019
1987,2206,4564,0,11,14,76,62,1,9.06114891437026
1987,2206,4734,0,7,-5,58,63,0,5.2538761793598
1987,3236,4734,0,3,-6,79,85,0,0.700506674788269
1987,3820,4734,0,9,1,77,76,1,9.08818166380935
1987,8748,4734,0,8,-10,62,72,0,2.43085274555994
1987,7002,4841,0,11,25,93,68,1,19.7914045137984
1987,8714,4909,0,9,16,76,60,1,9.80587038463871
1987,5852,5214,0,1,-15,82,97,0,-5.55142517555343
1987,6283,5214,0,8,12,109,97,1,10.2226910652761
1987,10788,5384,0,-9,1,70,69,1,-10.7567095202454
1987,1518,5447,0,9,-5,60,65,0,8.09326265492856
1987,4151,5447,0,8,4,67,63,1,4.15443681569228
1987,6544,5717,0,7,13,84,71,1,7.62933272375878
1987,5214,5852,0,-1,15,97,82,1,5.55142517555263
1987,75,5886,0,13,17,88,71,1,20.7839564525307
1987,2781,5931,0,5,12,82,70,1,8.68747786982678
1987,75,6150,0,5,25,101,76,1,8.32751507668723
1987,1049,6150,0,-3,-4,79,83,0,-2.17113136061858
1987,5214,6283,0,-8,-12,97,109,0,-10.2226910652789
1987,6544,6283,0,-4,-6,68,74,0,-13.7961565855792
1987,6900,6283,0,-15,-31,82,113,0,-25.1782846848567
1987,8664,6283,0,-1,4,79,75,1,-8.16971258903816
1987,7203,6374,0,11,9,104,95,1,15.317928042823
1987,5717,6544,0,-7,-13,71,84,0,-7.62933272375749
1987,6283,6544,0,4,6,74,68,1,13.7961565855764
1987,8714,6544,0,1,-1,57,58,0,1.54899898213865
1987,3134,6631,0,8,3,82,79,1,2.82337886215615
1987,4266,6631,0,1,-14,77,91,0,-2.60661164296298
1987,3922,6666,0,4,2,93,91,1,4.23109923299852
1987,7002,6666,0,3,-3,93,96,0,-0.219560013273952
1987,9169,6666,0,-5,-5,69,74,0,-7.22392485060212
1987,6283,6900,0,15,31,113,82,1,25.1782846848526
1987,4841,7002,0,-11,-25,68,93,0,-19.7914045137977
1987,6666,7002,0,-3,3,96,93,1,0.21956001327673
1987,75,7169,0,4,-21,82,103,0,5.8765884631899
1987,556,7169,0,-8,-3,87,90,0,-12.5790560092644
1987,3134,7169,0,5,-15,73,88,0,3.11706652518382
1987,8664,7169,0,4,14,77,63,1,2.80202342417815
1987,9271,7169,0,-5,-22,68,90,0,-8.8979935508509
1987,2781,7203,0,-3,19,85,66,1,1.20600811475455
1987,6374,7203,0,-11,-9,95,104,0,-15.3179280428244
1987,515,7661,0,1,1,62,61,1,6.00638440427674
1987,3922,7830,0,13,23,99,76,1,17.6132775586387
1987,8748,8241,0,13,19,75,56,1,16.191942765897
1987,2206,8407,0,3,8,83,75,1,3.10258906682984
1987,10566,8407,0,-5,-2,55,57,0,-6.22570554915022
1987,2781,8664,0,-4,-6,81,87,0,3.22775718754567
1987,3050,8664,0,-13,-6,73,79,0,-22.2488130673138
1987,3820,8664,0,1,1,74,73,1,3.23503916401317
1987,6283,8664,0,1,-4,75,79,0,8.1697125890341
1987,7169,8664,0,-4,-14,63,77,0,-2.80202342417915
1987,10226,8664,0,-8,-18,86,104,0,-3.5268318881253
1987,4909,8714,0,-9,-16,60,76,0,-9.80587038463724
1987,6544,8714,0,-1,1,58,57,1,-1.54899898213844
1987,4734,8748,0,-8,10,72,62,1,-2.43085274556141
1987,8241,8748,0,-13,-19,56,75,0,-16.1919427658976
1987,2342,8918,0,7,7,58,51,1,12.5393376078031
1987,6666,9169,0,5,5,74,69,1,7.22392485060539
1987,7169,9271,0,5,22,90,68,1,8.89799355085046
1987,1083,9404,0,-9,-19,73,92,0,-6.88462267544882
1987,10754,9404,0,-8,10,78,68,1,-6.76424648194108
1987,3679,9631,0,-15,-25,70,95,0,-24.2998599554552
1987,3820,9631,0,0,4,97,93,1,-3.12616841745583
1987,3922,9631,0,-1,-3,81,84,0,-2.46348431273028
1987,4185,9631,0,-8,-19,61,80,0,-12.7390327108086
1987,10754,9631,0,-11,-14,78,92,0,-16.5340384813554
1987,290,9849,0,-3,-7,91,98,0,3.95962745701985
1987,3922,9849,0,5,2,84,82,1,10.6496834603288
1987,10754,10056,0,-7,4,64,60,1,-7.5842094282483
1987,8664,10226,0,8,18,104,86,1,3.52683188812433
1987,10470,10226,0,3,-2,62,64,0,-3.06207173296686
1987,10226,10470,0,-3,2,64,62,1,3.0620717329663
1987,8407,10566,0,5,2,57,55,1,6.22570554914962
1987,9404,10754,0,8,-10,68,78,0,6.76424648194064
1987,9631,10754,0,11,14,92,78,1,16.5340384813537
1987,10056,10754,0,7,-4,60,64,0,7.58420942824909
1987,2342,10788,0,8,5,65,60,1,17.0889153051175
1987,5384,10788,0,9,-1,69,70,0,10.7567095202464
1988,1849,291,0,-15,-40,50,90,0,-33.2748472756948
1988,3923,291,0,-4,-20,79,99,0,-5.92362927463064
1988,6284,291,0,-1,-18,52,70,0,-9.15978855856132
1988,6667,291,0,0,8,86,78,1,1.69471084844541
1988,7962,291,0,-7,-29,55,84,0,-13.3493452560657
1988,10023,413,0,5,8,82,74,1,1.71390103421306
1988,869,516,0,-1,-4,86,90,0,-1.47411511137451
1988,6667,516,0,7,20,107,87,1,15.0514966219313
1988,5080,625,0,-1,15,75,60,1,3.34113945309154
1988,5215,733,0,11,5,63,58,1,10.9102794823914
1988,2343,801,0,13,16,85,69,1,24.1525158757669
1988,516,869,0,1,4,90,86,1,1.47411511138082
1988,1349,1050,0,-9,-6,92,98,0,-10.4712330975478
1988,4599,1050,0,-1,21,97,76,1,0.910515369934693
1988,1050,1349,0,9,6,98,92,1,10.4712330975463
1988,6667,1383,0,15,28,94,66,1,31.7812824844898
1988,291,1849,0,15,40,90,50,1,33.2748472757065
1988,4186,2207,0,1,8,66,58,1,4.00570325322286
1988,10567,2207,0,-7,-21,62,83,0,-3.45560889194031
1988,801,2343,0,-13,-16,69,85,0,-24.1525158757636
1988,4152,2343,0,-4,7,66,59,1,-10.2331857530625
1988,7292,2343,0,-9,-1,72,73,0,-16.0058319264198
1988,8062,2343,0,-5,-15,79,94,0,-13.035381961279
1988,8749,2343,0,1,-10,53,63,0,-6.41518310179216
1988,7003,2479,0,13,18,108,90,1,15.3571983908591
1988,7204,2678,0,15,15,94,79,1,26.93785418023
1988,5215,2782,0,3,23,108,85,1,7.47861584101912
1988,8408,2782,0,-5,-3,59,62,0,-3.49519729660696
1988,3923,2881,0,7,4,102,98,1,10.5802187788157
1988,4735,3135,0,-1,-3,63,66,0,-3.29169520867574
1988,8749,3135,0,7,21,74,53,1,2.93942761557967
1988,3957,3237,0,-7,-12,78,90,0,-1.09396277504812
1988,7360,3237,0,-8,4,59,55,1,-11.105670177547
1988,9734,3748,0,-11,-9,72,81,0,-18.8486818126563
1988,10023,3748,0,-3,3,66,63,1,-9.06190791277492
1988,7360,3821,0,-9,3,72,69,1,-15.2918735444982
1988,291,3923,0,4,20,99,79,1,5.92362927464871
1988,2881,3923,0,-7,-4,98,102,0,-10.5802187788087
1988,9632,3923,0,1,-18,86,104,0,-3.89800103005397
1988,3237,3957,0,7,12,90,78,1,1.09396277504619
1988,2343,4152,0,4,-7,59,66,0,10.2331857530683
1988,4186,4152,0,2,-13,58,71,0,1.75356652375588
1988,5752,4152,0,-8,-3,58,61,0,-10.5567740853633
1988,6667,4152,0,5,-4,79,83,0,15.8337847112936
1988,9955,4152,0,-1,-13,64,77,0,0.520232875600733
1988,10789,4152,0,-5,-13,72,85,0,-3.84840571434097
1988,2207,4186,0,-1,-8,58,66,0,-4.00570325322169
1988,4152,4186,0,-2,13,71,58,1,-1.75356652375103
1988,4301,4186,0,-9,-13,53,66,0,-10.098273139228
1988,7204,4186,0,3,-3,70,73,0,6.58684677786378
1988,4944,4267,0,-5,-9,81,90,0,-8.02879394933207
1988,8242,4267,0,-13,-15,84,99,0,-18.5237088076683
1988,10023,4267,0,-4,6,80,74,1,-6.5761055625021
1988,4186,4301,0,9,13,66,53,1,10.0982731392284
1988,8749,4403,0,15,14,87,73,1,19.6292749651673
1988,1050,4599,0,1,-21,76,97,0,-0.910515369939038
1988,6667,4599,0,4,10,108,98,1,14.5725983111009
1988,6833,4599,0,-7,-9,61,70,0,-4.0492897059893
1988,6284,4633,0,8,26,123,97,1,5.0773125068636
1988,10755,4633,0,3,-4,115,119,0,1.14989453377179
1988,3135,4735,0,1,3,66,63,1,3.29169520867923
1988,4267,4944,0,5,9,90,81,1,8.0287939493304
1988,7797,4944,0,-3,-10,82,92,0,-1.23089323940544
1988,625,5080,0,1,-15,60,75,0,-3.34113945309262
1988,7204,5080,0,8,27,100,73,1,12.1599597459101
1988,733,5215,0,-11,-5,58,63,0,-10.9102794823934
1988,2782,5215,0,-3,-23,85,108,0,-7.47861584102316
1988,6284,5215,0,1,9,78,69,1,-3.85483748364676
1988,7292,5385,0,-5,7,87,80,1,-10.2060463231398
1988,9632,5448,0,9,4,54,50,1,11.04025159421
1988,4152,5752,0,8,3,61,58,1,10.5567740853677
1988,5932,5752,0,11,-3,75,78,0,14.4834515831319
1988,8665,5887,0,11,14,69,55,1,20.7804108240477
1988,5752,5932,0,-11,3,78,75,1,-14.4834515831286
1988,291,6284,0,1,18,70,52,1,9.15978855857597
1988,4633,6284,0,-8,-26,97,123,0,-5.07731250685948
1988,5215,6284,0,-1,-9,69,78,0,3.85483748364964
1988,6341,6284,0,-13,-18,65,83,0,-17.2876953794158
1988,6284,6341,0,13,18,83,65,1,17.2876953794184
1988,8062,6545,0,3,8,83,75,1,-1.46549267848468
1988,291,6667,0,0,-8,78,86,0,-1.69471084843215
1988,516,6667,0,-7,-20,87,107,0,-15.0514966219277
1988,1383,6667,0,-15,-28,66,94,0,-31.7812824844902
1988,4152,6667,0,-5,4,83,79,1,-15.8337847112892
1988,4599,6667,0,-4,-10,98,108,0,-14.5725983110993
1988,10023,6667,0,-5,-19,59,78,0,-16.4805123551772
1988,4599,6833,0,7,9,70,61,1,4.0492897059909
1988,2479,7003,0,-13,-18,90,108,0,-15.3571983908621
1988,9955,7003,0,-5,6,80,74,1,-2.6953328545843
1988,2678,7204,0,-15,-15,79,94,0,-26.9378541802336
1988,4186,7204,0,-3,3,73,70,1,-6.58684677786617
1988,5080,7204,0,-8,-27,73,100,0,-12.1599597459134
1988,2343,7292,0,9,1,73,72,1,16.005831926424
1988,5385,7292,0,5,-7,80,87,0,10.2060463231435
1988,8665,7292,0,8,-3,94,97,0,15.116547853463
1988,3237,7360,0,8,-4,55,59,0,11.1056701775436
1988,3821,7360,0,9,-3,69,72,0,15.2918735444948
1988,8749,7360,0,12,22,69,47,1,14.6981369954064
1988,4944,7797,0,3,10,92,82,1,1.23089323940502
1988,291,7962,0,7,29,84,55,1,13.3493452560786
1988,9850,7962,0,-1,-16,64,80,0,-4.05226637006893
1988,2343,8062,0,5,15,94,79,1,13.0353819612815
1988,6545,8062,0,-3,-8,75,83,0,1.46549267848402
1988,4267,8242,0,13,15,99,84,1,18.523708807667
1988,2782,8408,0,5,3,62,59,1,3.49519729660245
1988,5887,8665,0,-11,-14,55,69,0,-20.7804108240496
1988,7292,8665,0,-8,3,97,94,1,-15.1165478534634
1988,2343,8749,0,-1,10,63,53,1,6.41518310179555
1988,3135,8749,0,-7,-21,53,74,0,-2.93942761557499
1988,4403,8749,0,-15,-14,73,87,0,-19.6292749651664
1988,7360,8749,0,-12,-22,47,69,0,-14.6981369954042
1988,3923,9632,0,-1,18,104,86,1,3.89800103005953
1988,5448,9632,0,-9,-4,50,54,0,-11.0402515942097
1988,3748,9734,0,11,9,81,72,1,18.8486818126547
1988,9955,9802,0,3,3,80,77,1,2.49252523174004
1988,7962,9850,0,1,16,80,64,1,4.05226637006959
1988,4152,9955,0,1,13,77,64,1,-0.520232875597291
1988,7003,9955,0,5,-6,74,80,0,2.69533285458266
1988,9802,9955,0,-3,-3,77,80,0,-2.49252523173985
1988,413,10023,0,-5,-8,74,82,0,-1.71390103420783
1988,3748,10023,0,3,-3,63,66,0,9.06190791277467
1988,4267,10023,0,4,-6,74,80,0,6.57610556250183
1988,6667,10023,0,5,19,78,59,1,16.4805123551785
1988,2207,10567,0,7,21,83,62,1,3.4556088919398
1988,4633,10755,0,-3,4,119,115,1,-1.14989453376983
1988,4152,10789,0,5,13,85,72,1,3.84840571434431
1989,8097,77,0,-5,2,86,84,1,3.39534130628246
1989,1520,292,0,-8,-26,68,94,0,-16.8692518773508
1989,7429,292,0,-15,-34,60,94,0,-37.3756229177187
1989,9633,292,0,-3,1,68,67,1,-10.6467663029901
1989,4600,360,0,9,5,76,71,1,7.97932781978264
1989,4600,414,0,1,9,93,84,1,0.524036034807518
1989,4634,414,0,-7,-19,101,120,0,-9.3680793405082
1989,3749,592,0,8,12,72,60,1,16.4304452643789
1989,7004,592,0,1,-4,64,68,0,2.24653513757165
1989,8666,956,0,13,23,104,81,1,25.6296784339592
1989,292,1520,0,8,26,94,68,1,16.8692518773546
1989,8511,1520,0,1,-13,70,83,0,5.23605483922615
1989,2783,1715,0,3,-22,46,68,0,1.01950355274548
1989,8666,1715,0,8,15,65,50,1,15.0683818579163
1989,5386,1884,0,11,16,85,69,1,17.3359429954574
1989,5081,2208,0,7,-3,63,66,0,3.10692098762932
1989,9633,2208,0,8,15,85,70,1,8.29754312673086
1989,3136,2344,0,1,-8,77,85,0,-4.98384213731896
1989,5284,2344,0,-9,-17,70,87,0,-12.2199039605521
1989,7497,2344,0,-13,-21,69,90,0,-30.7776758011517
1989,7963,2344,0,-1,17,95,78,1,-7.09788033505235
1989,10472,2344,0,-5,-7,63,70,0,-15.7092994283583
1989,6668,2611,0,15,1,72,71,1,26.1228380233948
1989,6834,2645,0,5,-4,90,94,0,4.92836251766045
1989,7963,2645,0,8,14,87,73,1,6.97002400074839
1989,1715,2783,0,-3,22,68,46,1,-1.01950355274612
1989,5719,2882,0,-9,14,97,83,1,-11.413642379085
1989,3822,3102,0,13,14,99,85,1,24.2289261743452
1989,2344,3136,0,-1,8,85,77,1,4.98384213732266
1989,5933,3136,0,-4,-8,61,69,0,-3.36502095071601
1989,6546,3136,0,-8,-7,74,81,0,-10.2374302602312
1989,7137,3136,0,-15,-1,49,50,0,-24.2467694570017
1989,8886,3238,0,-5,6,76,70,1,-4.94497802605645
1989,9633,3647,0,9,12,68,56,1,6.68064848543406
1989,592,3749,0,-8,-12,60,72,0,-16.4304452643825
1989,4600,3749,0,-3,-14,69,83,0,-7.7237756479471
1989,5013,3749,0,-15,-6,71,77,0,-28.6772700365431
1989,5216,3749,0,-2,2,83,81,1,2.56840197624416
1989,8666,3749,0,-1,-3,86,89,0,-3.60132936473264
1989,3102,3822,0,-13,-14,85,99,0,-24.2289261743463
1989,7963,3822,0,-1,13,78,65,1,-1.97638230902713
1989,9851,3822,0,-5,-23,69,92,0,-7.40823357802266
1989,5933,3924,0,-1,6,102,96,1,-2.02796708154799
1989,7463,3924,0,-9,-14,73,87,0,-17.4674407239823
1989,9406,3958,0,3,10,84,74,1,3.29180515740923
1989,5284,4187,0,-5,11,86,75,1,-0.60766988572975
1989,4566,4302,0,-1,9,83,74,1,-3.46068765911463
1989,4302,4566,0,1,-9,74,83,0,3.46068765911516
1989,6668,4566,0,8,43,124,81,1,16.8581575545034
1989,360,4600,0,-9,-5,71,76,0,-7.9793278197787
1989,414,4600,0,-1,-9,84,93,0,-0.524036034806681
1989,3749,4600,0,3,14,83,69,1,7.72377564794561
1989,414,4634,0,7,19,120,101,1,9.36807934050619
1989,9851,4736,0,3,11,85,74,1,4.59407304074772
1989,3749,5013,0,15,6,77,71,1,28.6772700365384
1989,2208,5081,0,-7,3,66,63,1,-3.10692098763045
1989,3749,5216,0,2,-2,81,83,0,-2.5684019762511
1989,6285,5216,0,1,-5,87,92,0,-4.8794909535775
1989,7963,5216,0,0,-1,79,80,0,-9.35481427527977
1989,8097,5216,0,-8,-9,82,91,0,-14.8309941703608
1989,10058,5216,0,-2,-37,65,102,0,-12.6658684676945
1989,10790,5216,0,-11,-5,87,92,0,-23.1739682261809
1989,2344,5284,0,9,17,87,70,1,12.2199039605548
1989,4187,5284,0,5,-11,75,86,0,0.607669885727841
1989,8029,5284,0,-3,-13,67,80,0,-5.28063258784257
1989,1884,5386,0,-11,-16,69,85,0,-17.3359429954595
1989,8666,5386,0,1,3,83,80,1,1.08178171974169
1989,8886,5386,0,-8,-19,89,108,0,-11.1742411823461
1989,7963,5449,0,11,9,60,51,1,13.0826439038125
1989,2882,5719,0,9,-14,83,97,0,11.4136423790827
1989,10058,5719,0,8,16,104,88,1,10.8080659160213
1989,3136,5933,0,4,8,69,61,1,3.36502095071668
1989,3924,5933,0,1,-6,96,102,0,2.02796708154957
1989,8131,5933,0,-7,-15,66,81,0,-9.42085722300288
1989,5216,6285,0,-1,5,92,87,1,4.87949095357262
1989,8243,6285,0,-13,-14,79,93,0,-24.1943590064494
1989,9406,6285,0,-5,-7,81,88,0,-9.45843721441631
1989,3136,6546,0,8,7,81,74,1,10.2374302602313
1989,9956,6546,0,1,-16,65,81,0,2.08873881009746
1989,2611,6668,0,-15,-1,71,72,0,-26.1228380233936
1989,4566,6668,0,-8,-43,81,124,0,-16.8581575545028
1989,10058,6668,0,-4,6,86,80,1,-9.04513109765835
1989,2645,6834,0,-5,4,94,90,1,-4.92836251766175
1989,592,7004,0,-1,4,68,64,1,-2.24653513756972
1989,3136,7137,0,15,1,50,49,1,24.2467694570012
1989,10058,7171,0,7,3,100,97,1,-0.510097701558864
1989,292,7429,0,15,34,94,60,1,37.3756229177203
1989,3924,7463,0,9,14,87,73,1,17.4674407239821
1989,2344,7497,0,13,21,90,69,1,30.7776758011547
1989,2344,7963,0,1,-17,78,95,0,7.09788033505748
1989,2645,7963,0,-8,-14,73,87,0,-6.97002400074888
1989,3822,7963,0,1,-13,65,78,0,1.97638230902631
1989,5216,7963,0,0,1,80,79,1,9.35481427527824
1989,5449,7963,0,-11,-9,51,60,0,-13.0826439038118
1989,9633,7963,0,-1,-23,61,84,0,-1.15584987070355
1989,5284,8029,0,3,13,80,67,1,5.28063258784129
1989,8579,8029,0,11,-2,78,80,0,12.2480495465516
1989,77,8097,0,5,-2,84,86,0,-3.39534130628213
1989,5216,8097,0,8,9,91,82,1,14.8309941703585
1989,5933,8131,0,7,15,81,66,1,9.4208572230043
1989,6285,8243,0,13,14,93,79,1,24.1943590064467
1989,1520,8511,0,-1,13,83,70,1,-5.23605483922403
1989,8029,8579,0,-11,2,80,78,1,-12.2480495465514
1989,956,8666,0,-13,-23,81,104,0,-25.6296784339559
1989,1715,8666,0,-8,-15,50,65,0,-15.0683818579162
1989,3749,8666,0,1,3,89,86,1,3.60132936472884
1989,5386,8666,0,-1,-3,80,83,0,-1.08178171974292
1989,10472,8784,0,3,16,84,68,1,0.0810904827782712
1989,3238,8886,0,5,-6,70,76,0,4.94497802605686
1989,5386,8886,0,8,19,108,89,1,11.1742411823447
1989,3958,9406,0,-3,-10,74,84,0,-3.29180515741033
1989,6285,9406,0,5,7,88,81,1,9.45843721441356
1989,292,9633,0,3,-1,67,68,0,10.6467663029931
1989,2208,9633,0,-8,-15,70,85,0,-8.29754312672954
1989,3647,9633,0,-9,-12,56,68,0,-6.6806484854343
1989,7963,9633,0,1,23,84,61,1,1.1558498707054
1989,3822,9851,0,5,23,92,69,1,7.40823357802058
1989,4736,9851,0,-3,-11,74,85,0,-4.59407304074681
1989,6546,9956,0,-1,16,81,65,1,-2.08873881009615
1989,5216,10058,0,2,37,102,65,1,12.6658684676917
1989,5719,10058,0,-8,-16,88,104,0,-10.8080659160218
1989,6668,10058,0,4,-6,80,86,0,9.04513109765939
1989,7171,10058,0,-7,-3,97,100,0,0.510097701556955
1989,2344,10472,0,5,7,70,63,1,15.7092994283626
1989,8784,10472,0,-3,-16,68,84,0,-0.0810904827791195
1989,5216,10790,0,11,5,92,87,1,23.1739682261793
1990,293,78,0,5,-22,55,77,0,8.25230185414347
1990,1716,78,0,-3,-17,54,71,0,-3.44799980486781
1990,4635,78,0,-4,2,62,60,1,0.70808650606541
1990,78,293,0,-5,22,77,55,1,-8.25230185414074
1990,8176,293,0,-13,-12,67,79,0,-21.3388847140553
1990,9634,361,0,15,30,102,72,1,22.530814649393
1990,2087,415,0,-8,-2,84,86,0,-11.2798019638952
1990,2345,415,0,1,14,97,83,1,1.31332910493952
1990,6286,415,0,-4,-23,73,96,0,-4.78517220448701
1990,7138,415,0,-9,-4,64,68,0,-16.0015628894384
1990,8887,415,0,-6,-3,85,88,0,-8.13006346043616
1990,4601,593,0,8,-2,60,62,0,5.70955430682363
1990,6835,593,0,7,-1,53,54,0,2.74123010809333
1990,9634,593,0,11,2,69,67,1,11.5671181721358
1990,1784,803,0,15,24,76,52,1,19.1789015851329
1990,1521,1052,0,7,2,49,47,1,6.20581152978091
1990,1784,1144,0,8,20,74,54,1,6.27172508487112
1990,3823,1144,0,1,-2,63,65,0,8.17058071252396
1990,1052,1521,0,-7,-2,47,49,0,-6.20581152977856
1990,1784,1521,0,4,1,71,70,1,2.18024546314918
1990,4303,1521,0,1,-4,75,79,0,-2.63171314575218
1990,78,1716,0,3,17,71,54,1,3.44799980487342
1990,803,1784,0,-15,-24,52,76,0,-19.1789015851302
1990,1144,1784,0,-8,-20,54,74,0,-6.27172508487273
1990,1521,1784,0,-4,-1,70,71,0,-2.18024546314467
1990,2345,1784,0,-2,1,79,78,1,3.87122639590491
1990,8667,1817,0,13,22,70,48,1,21.5996778975315
1990,415,2087,0,8,2,86,84,1,11.2798019639034
1990,3750,2087,0,7,-2,86,88,0,10.5448149880574
1990,415,2345,0,-1,-14,83,97,0,-1.31332910493815
1990,1784,2345,0,2,-1,78,79,0,-3.87122639590581
1990,7362,2345,0,-11,-35,46,81,0,-20.199043757862
1990,8410,2345,0,-3,-4,72,76,0,-9.35293442171381
1990,9407,2345,0,-4,-9,81,90,0,-8.57870132469336
1990,9634,2345,0,2,30,103,73,1,1.46156594318889
1990,3239,2612,0,9,16,99,83,1,11.8524972725081
1990,9240,3137,0,-11,-18,52,70,0,-21.2658374635422
1990,10791,3137,0,-3,3,74,71,1,-8.67339374606286
1990,8887,3171,0,-3,12,100,88,1,0.468137945180354
1990,2612,3239,0,-9,-16,83,99,0,-11.8524972725099
1990,4737,3239,0,-1,-3,91,94,0,-1.69957414337369
1990,5251,3239,0,3,-1,80,81,0,-0.00957221822633514
1990,5285,3239,0,-2,-2,91,93,0,1.66182712010813
1990,9634,3239,0,3,9,90,81,1,5.30654017319414
1990,7799,3564,0,-1,4,70,66,1,1.92342433168009
1990,4601,3648,0,9,19,78,59,1,9.88450900421055
1990,2087,3750,0,-7,2,88,86,1,-10.5448149880505
1990,5217,3784,0,11,6,76,70,1,16.3334618675006
1990,1144,3823,0,-1,2,65,63,1,-8.17058071252627
1990,7430,4154,0,-13,-8,71,79,0,-27.6908243393754
1990,9407,4154,0,-5,1,71,70,1,-13.9063311753422
1990,10791,4188,0,5,8,87,79,1,-0.219538055935171
1990,1521,4303,0,-1,4,79,75,1,2.63171314575028
1990,8210,4303,0,-9,-16,63,79,0,-6.92693676706099
1990,593,4601,0,-8,2,62,60,1,-5.70955430682085
1990,3648,4601,0,-9,-19,59,78,0,-9.88450900420974
1990,78,4635,0,4,-2,60,62,0,-0.708086506060855
1990,5217,4635,0,8,-34,115,149,0,5.26985763316316
1990,6119,4635,0,5,-19,92,111,0,-3.32787863053022
1990,9634,4635,0,10,30,131,101,1,7.93731179363983
1990,3239,4737,0,1,3,94,91,1,1.69957414337236
1990,10025,4737,0,-7,-7,63,70,0,-5.63852340243215
1990,3784,5217,0,-11,-6,70,76,0,-16.3334618675023
1990,4635,5217,0,-8,34,149,115,1,-5.26985763316428
1990,3239,5251,0,-3,1,81,80,1,0.00957221822478616
1990,5754,5251,0,-15,-4,71,75,0,-20.6251913174268
1990,7799,5251,0,-8,-4,58,62,0,-5.01285964700537
1990,3239,5285,0,2,2,93,91,1,-1.66182712010632
1990,6445,5285,0,-8,-3,78,81,0,-15.9894004960868
1990,8667,5285,0,4,-7,75,82,0,-0.469204076558984
1990,9852,5285,0,-5,-3,61,64,0,-10.1200703977362
1990,6445,5387,0,-11,3,74,71,1,-13.5441988665173
1990,6286,5450,0,1,13,83,70,1,4.36418039923681
1990,5251,5754,0,15,4,75,71,1,20.6251913174266
1990,4635,6119,0,-5,19,111,92,1,3.32787863052897
1990,415,6286,0,4,23,96,73,1,4.78517220449215
1990,5450,6286,0,-1,-13,70,83,0,-4.36418039923772
1990,6669,6286,0,7,-2,77,79,0,12.4311372922092
1990,5285,6445,0,8,3,81,78,1,15.9894004960901
1990,5387,6445,0,11,-3,71,74,0,13.5441988665155
1990,10059,6547,0,3,8,75,67,1,-0.620932205230581
1990,7172,6634,0,-1,-1,83,84,0,-1.09498174429815
1990,9634,6634,0,7,11,76,65,1,8.37228997328165
1990,6286,6669,0,-7,2,79,77,1,-12.4311372922116
1990,9083,6669,0,-15,-9,68,77,0,-33.1483141397906
1990,593,6835,0,-7,1,54,53,1,-2.74123010808993
1990,415,7138,0,9,4,68,64,1,16.0015628894438
1990,6634,7172,0,1,1,84,83,1,1.09498174429875
1990,8887,7206,0,-8,1,73,72,1,-6.52864794890601
1990,9475,7206,0,-13,-12,63,75,0,-15.3411133003242
1990,2345,7362,0,11,35,81,46,1,20.1990437578581
1990,4154,7430,0,13,8,79,71,1,27.6908243393713
1990,3564,7799,0,1,-4,66,70,0,-1.92342433167967
1990,5251,7799,0,8,4,62,58,1,5.01285964700628
1990,293,8176,0,13,12,79,67,1,21.3388847140545
1990,4303,8210,0,9,16,79,63,1,6.92693676705728
1990,2345,8410,0,3,4,76,72,1,9.35293442171083
1990,8751,8410,0,-5,-16,65,81,0,-3.34999944405615
1990,1817,8667,0,-13,-22,48,70,0,-21.5996778975327
1990,5285,8667,0,-4,7,82,75,1,0.469204076561407
1990,10059,8667,0,-5,-2,61,63,0,-7.31835197474606
1990,8410,8751,0,5,16,81,65,1,3.34999944405759
1990,415,8887,0,6,3,88,85,1,8.13006346044118
1990,3171,8887,0,3,-12,88,100,0,-0.468137945180752
1990,7206,8887,0,8,-1,72,73,0,6.52864794890452
1990,10791,8887,0,4,-13,89,102,0,0.929838365310401
1990,6669,9083,0,15,9,77,68,1,33.148314139788
1990,3137,9240,0,11,18,70,52,1,21.2658374635396
1990,9407,9274,0,3,12,68,56,1,0.00938281099766058
1990,2345,9407,0,4,9,90,81,1,8.57870132468986
1990,4154,9407,0,5,-1,70,71,0,13.9063311753382
1990,9274,9407,0,-3,-12,56,68,0,-0.0093828109977796
1990,7206,9475,0,13,12,75,63,1,15.3411133003229
1990,361,9634,0,-15,-30,72,102,0,-22.530814649394
1990,593,9634,0,-11,-2,67,69,0,-11.5671181721355
1990,2345,9634,0,-2,-30,73,103,0,-1.46156594319383
1990,3239,9634,0,-3,-9,81,90,0,-5.30654017319721
1990,4635,9634,0,-10,-30,101,131,0,-7.93731179364074
1990,6634,9634,0,-7,-11,65,76,0,-8.37228997328186
1990,5285,9852,0,5,3,64,61,1,10.1200703977404
1990,4737,10025,0,7,7,70,63,1,5.63852340243164
1990,6547,10059,0,-3,-8,67,75,0,0.620932205231807
1990,8667,10059,0,5,2,63,61,1,7.31835197474559
1990,3137,10791,0,3,-3,71,74,0,8.67339374605933
1990,4188,10791,0,-5,-8,79,87,0,0.219538055935201
1990,8887,10791,0,-4,13,102,89,1,-0.929838365310541
1991,416,79,0,3,23,93,70,1,12.8302820228162
1991,5755,79,0,-9,-10,79,89,0,-9.63798003002918
1991,10338,79,0,-1,-8,88,96,0,-1.26454714273064
1991,1053,294,0,-8,-15,61,76,0,-16.4009231283994
1991,7965,294,0,-1,4,81,77,1,-7.43089277387627
1991,8377,294,0,-13,-13,80,93,0,-23.9617207772559
1991,416,328,0,7,7,97,90,1,13.2873259757259
1991,7465,328,0,-1,-3,76,79,0,-8.19509939053157
1991,79,416,0,-3,-23,70,93,0,-12.8302820228211
1991,328,416,0,-7,-7,90,97,0,-13.2873259757241
1991,3206,416,0,-15,-41,76,117,0,-35.7449895257587
1991,4155,416,0,-2,12,93,81,1,-3.65770146738402
1991,294,1053,0,8,15,76,61,1,16.4009231283951
1991,10060,1053,0,3,-13,48,61,0,7.22109921559446
1991,3824,1588,0,13,10,79,69,1,25.5381913354346
1991,2346,1785,0,9,14,81,67,1,8.41045232924704
1991,4738,1785,0,5,-17,62,79,0,3.71316177569066
1991,10792,1785,0,-3,-16,50,66,0,-11.324774771928
1991,6120,1886,0,5,-8,56,64,0,1.81587523037715
1991,7965,1886,0,8,12,81,69,1,6.27103638193785
1991,3240,2210,0,1,17,87,70,1,2.00115772277671
1991,1785,2346,0,-9,-14,67,81,0,-8.41045232925307
1991,3926,2346,0,-5,-15,70,85,0,-12.5010654135646
1991,4155,2346,0,-1,-7,65,72,0,0.382561588953031
1991,8411,2346,0,-2,-17,61,78,0,-11.0214138954055
1991,9476,2346,0,-13,-29,73,102,0,-22.5058864185532
1991,9635,2346,0,1,-2,77,79,0,8.2145090166254
1991,5354,2482,0,7,-20,56,76,0,4.72590389223286
1991,6287,2482,0,11,26,93,67,1,17.1568657026227
1991,6938,2482,0,-1,-3,68,71,0,-1.79824344042654
1991,3926,2613,0,3,3,76,73,1,-0.596994208299702
1991,3824,2884,0,5,22,82,60,1,15.496408281806
1991,9669,2884,0,-3,-3,72,75,0,4.66091581650655
1991,9635,3138,0,7,8,62,54,1,16.9081917781665
1991,9958,3138,0,-1,-10,60,70,0,-1.65679715321325
1991,7006,3172,0,5,8,76,68,1,-4.39923324726307
1991,416,3206,0,15,41,117,76,1,35.744989525759
1991,2210,3240,0,-1,-17,70,87,0,-2.00115772277646
1991,6635,3240,0,7,4,65,61,1,7.68718126708325
1991,1588,3824,0,-13,-10,69,79,0,-25.5381913354319
1991,2884,3824,0,-5,-22,60,82,0,-15.4964082818008
1991,4155,3824,0,-1,18,83,65,1,-0.409604967669246
1991,2346,3926,0,5,15,85,70,1,12.5010654135511
1991,2613,3926,0,-3,-3,73,76,0,0.596994208287882
1991,416,4155,0,2,-12,81,93,0,3.65770146738001
1991,2346,4155,0,1,7,72,65,1,-0.382561588967103
1991,3824,4155,0,1,-18,65,83,0,0.409604967666393
1991,6154,4155,0,-11,-6,49,55,0,-16.9186390762506
1991,6287,4155,0,2,-6,73,79,0,2.66558771692721
1991,7006,4155,0,-3,-11,66,77,0,-8.97405556718444
1991,10338,4568,0,7,6,71,65,1,4.62425212431488
1991,1785,4738,0,-5,17,79,62,1,-3.71316177569133
1991,9771,5252,0,1,1,85,84,1,-1.09061539522844
1991,10508,5252,0,-7,-2,58,60,0,-7.82178711405967
1991,2482,5354,0,-7,20,76,56,1,-4.72590389223694
1991,9635,5519,0,15,34,99,65,1,32.1107201976385
1991,79,5755,0,9,10,89,79,1,9.63798003002369
1991,8411,5816,0,9,7,75,68,1,4.93708029887544
1991,6704,5935,0,3,9,73,64,1,7.55558389882071
1991,8211,5935,0,-5,-29,85,114,0,-5.95879554129932
1991,10792,5984,0,-11,5,89,84,1,-15.1678478959799
1991,6704,6086,0,11,13,67,54,1,13.5619110699859
1991,1886,6120,0,-5,8,64,56,1,-1.8158752303778
1991,4155,6154,0,11,6,55,49,1,16.9186390762442
1991,2482,6287,0,-11,-26,67,93,0,-17.156865702626
1991,4155,6287,0,-2,6,79,73,1,-2.66558771693397
1991,6378,6287,0,-15,-35,66,101,0,-27.1920374840314
1991,8752,6287,0,-9,-3,72,75,0,-16.3551952935945
1991,10026,6287,0,-8,-15,69,84,0,-14.8632373011574
1991,6287,6378,0,15,35,101,66,1,27.1920374840305
1991,3240,6635,0,-7,-4,61,65,0,-7.68718126708203
1991,8411,6635,0,-3,17,91,74,1,-10.3926065760131
1991,9084,6635,0,-15,-11,86,97,0,-27.2420812935589
1991,5935,6704,0,-3,-9,64,73,0,-7.55558389881808
1991,6086,6704,0,-11,-13,54,67,0,-13.5619110699848
1991,8752,6704,0,-7,9,72,63,1,-11.3912963552294
1991,2482,6938,0,1,3,71,68,1,1.79824344042246
1991,9408,6938,0,9,-5,69,74,0,12.9838361906327
1991,7965,6972,0,11,20,71,51,1,11.221331253026
1991,3172,7006,0,-5,-8,68,76,0,4.39923324725944
1991,4155,7006,0,3,11,77,66,1,8.97405556717713
1991,10026,7139,0,-1,2,50,48,1,3.77175669375312
1991,8752,7207,0,-3,17,80,63,1,-2.63190418167707
1991,8668,7363,0,13,-4,69,73,0,16.1364593221507
1991,8752,7363,0,5,13,77,64,1,9.00499740080418
1991,328,7465,0,1,3,79,76,1,8.19509939053002
1991,294,7965,0,1,-4,77,81,0,7.43089277386945
1991,1886,7965,0,-8,-12,69,81,0,-6.27103638194269
1991,6972,7965,0,-11,-20,51,71,0,-11.2213312530266
1991,9635,7965,0,2,12,77,65,1,14.7480489106598
1991,9771,8099,0,9,10,82,72,1,4.36377268639038
1991,5935,8211,0,5,29,114,85,1,5.95879554129922
1991,294,8377,0,13,13,93,80,1,23.9617207772495
1991,2346,8411,0,2,17,78,61,1,11.0214138953979
1991,5816,8411,0,-9,-7,68,75,0,-4.93708029887445
1991,6635,8411,0,3,-17,74,91,0,10.3926065760132
1991,8888,8411,0,-1,-8,76,84,0,2.79242252862644
1991,8888,8547,0,7,8,73,65,1,9.16870264643083
1991,7363,8668,0,-13,4,73,69,1,-16.1364593221497
1991,6287,8752,0,9,3,75,72,1,16.3551952935935
1991,6704,8752,0,7,-9,63,72,0,11.3912963552305
1991,7207,8752,0,3,-17,63,80,0,2.63190418167497
1991,7363,8752,0,-5,-13,64,77,0,-9.00499740080505
1991,8411,8888,0,1,8,84,76,1,-2.79242252862673
1991,8547,8888,0,-7,-8,65,73,0,-9.16870264643142
1991,6635,9084,0,15,11,97,86,1,27.2420812935589
1991,6938,9408,0,-9,5,74,69,1,-12.9838361906344
1991,2346,9476,0,13,29,102,73,1,22.505886418546
1991,2346,9635,0,-1,2,79,77,1,-8.21450901663354
1991,3138,9635,0,-7,-8,54,62,0,-16.908191778166
1991,5519,9635,0,-15,-34,65,99,0,-32.1107201976389
1991,7965,9635,0,-2,-12,65,77,0,-14.7480489106617
1991,9771,9635,0,-3,-17,66,83,0,-20.3893963183853
1991,2884,9669,0,3,3,75,72,1,-4.66091581650502
1991,5252,9771,0,-1,-1,84,85,0,1.09061539522812
1991,8099,9771,0,-9,-10,72,82,0,-4.36377268638864
1991,9635,9771,0,3,17,83,66,1,20.3893963183853
1991,3138,9958,0,1,10,70,60,1,1.65679715321488
1991,6287,10026,0,8,15,84,69,1,14.8632373011571
1991,7139,10026,0,1,-2,48,50,0,-3.77175669375311
1991,1053,10060,0,-3,13,61,48,1,-7.22109921559228
1991,79,10338,0,1,8,96,88,1,1.26454714272388
1991,4568,10338,0,-7,-6,65,71,0,-4.62425212431283
1991,5252,10508,0,7,2,60,58,1,7.8217871140593
1991,1785,10792,0,3,16,66,50,1,11.3247747719296
1991,5984,10792,0,11,-5,84,89,0,15.1678478959784
1992,6288,80,0,1,9,64,55,1,4.60964484399233
1992,8582,80,0,-7,-5,75,80,0,2.95255347262227
1992,2614,295,0,-11,7,87,80,1,-19.4038588856565
1992,5084,417,0,-3,2,82,80,1,-7.19238692317781
1992,5756,417,0,-11,-11,69,80,0,-18.3238815585439
1992,4739,1054,0,3,11,94,83,1,5.86777969050711
1992,2347,1180,0,15,26,82,56,1,34.7642404276982
1992,3961,1353,0,-3,2,76,74,1,5.35873754061801
1992,2123,1455,0,-9,-38,47,85,0,-19.4797310756331
1992,5084,1455,0,-2,-31,57,88,0,-7.91513793521119
1992,5219,1455,0,-2,4,76,72,1,-2.07631443197726
1992,5253,1455,0,-1,-12,65,77,0,-2.40348604992157
1992,9854,1455,0,-5,-2,67,69,0,-7.94002216109325
1992,5985,1786,0,1,-21,65,86,0,-0.9990438764857
1992,6636,1786,0,8,23,78,55,1,9.48844579021047
1992,1455,2123,0,9,38,85,47,1,19.4797310756285
1992,6121,2211,0,-7,8,81,73,1,-2.83360523375493
1992,1180,2347,0,-15,-26,56,82,0,-34.7642404277042
1992,3825,2347,0,-1,-3,78,81,0,5.53112712993081
1992,3927,2347,0,-8,-13,62,75,0,-5.92191289844513
1992,4271,2347,0,-1,-1,103,104,0,-3.42772284911513
1992,5219,2347,0,-5,-20,51,71,0,-5.65264036266692
1992,7966,2347,0,-3,-12,69,81,0,-10.5506663944502
1992,3825,2415,0,13,39,94,55,1,31.4867525075955
1992,295,2614,0,11,-7,80,87,0,19.4038588856594
1992,5219,2614,0,8,12,102,90,1,12.7313660590262
1992,9854,2648,0,-1,5,55,50,1,-0.339679389092797
1992,3139,2885,0,-3,-10,68,78,0,-2.56910605161502
1992,3825,2885,0,1,11,85,74,1,15.3441906200567
1992,5520,2885,0,-11,-10,68,78,0,-6.62230252127341
1992,4982,2919,0,11,27,85,58,1,15.168259957408
1992,6705,3055,0,13,27,100,73,1,18.6505345896654
1992,2885,3139,0,3,10,78,68,1,2.56910605161912
1992,8178,3139,0,-5,-15,60,75,0,-4.96413706335909
1992,3566,3241,0,-3,-5,60,65,0,-4.58999634087978
1992,5084,3241,0,1,4,83,79,1,-4.12949472676537
1992,9670,3241,0,5,-1,78,79,0,-4.17687217706795
1992,3241,3566,0,3,5,65,60,1,4.58999634088369
1992,4156,3616,0,15,33,100,67,1,39.4721975768192
1992,2347,3825,0,1,3,81,78,1,-5.53112712994288
1992,2415,3825,0,-13,-39,55,94,0,-31.4867525075996
1992,2885,3825,0,-1,-11,74,85,0,-15.3441906200592
1992,4739,3825,0,-5,-10,79,89,0,-9.52966536343643
1992,9409,3825,0,1,-27,79,106,0,-9.10413594687335
1992,2347,3927,0,8,13,75,62,1,5.92191289844213
1992,8889,3927,0,1,-6,92,98,0,-6.74947581331933
1992,1353,3961,0,3,-2,74,76,0,-5.35873754061723
1992,4271,3961,0,8,8,106,98,1,6.33831869059448
1992,3616,4156,0,-15,-33,67,100,0,-39.4721975768151
1992,9854,4156,0,-8,6,66,60,1,-13.9787570181685
1992,2347,4271,0,1,1,104,103,1,3.42772284911113
1992,3961,4271,0,-8,-8,98,106,0,-6.33831869059164
1992,4982,4271,0,-1,-10,77,87,0,-4.29161095458026
1992,6739,4271,0,-13,-19,69,88,0,-24.563019003484
1992,7966,4305,0,9,2,78,76,1,5.46207263233863
1992,9409,4603,0,7,16,85,69,1,8.29734767365053
1992,10339,4603,0,-1,-23,58,81,0,1.96020671672188
1992,1054,4739,0,-3,-11,83,94,0,-5.86777969049772
1992,3825,4739,0,5,10,89,79,1,9.52966536343609
1992,2919,4982,0,-11,-27,58,85,0,-15.1682599574043
1992,4271,4982,0,1,10,87,77,1,4.29161095458631
1992,8669,4982,0,-3,-6,71,77,0,-5.45916424103529
1992,417,5084,0,3,-2,80,82,0,7.19238692317854
1992,1455,5084,0,2,31,88,57,1,7.91513793520853
1992,3241,5084,0,-1,-4,79,83,0,4.12949472676706
1992,6973,5084,0,-5,-10,70,80,0,-3.12975589572739
1992,6288,5185,0,9,5,68,63,1,9.74547710721772
1992,1455,5219,0,2,-4,72,76,0,2.07631443197542
1992,2347,5219,0,5,20,71,51,1,5.65264036265953
1992,2614,5219,0,-8,-12,90,102,0,-12.7313660590283
1992,6636,5219,0,5,-4,71,75,0,5.85378609909149
1992,6705,5219,0,4,-3,72,75,0,3.37816669634424
1992,8753,5219,0,-5,-7,66,73,0,-8.17194348071086
1992,1455,5253,0,1,12,77,65,1,2.40348604992073
1992,5452,5253,0,-7,-7,54,61,0,-12.126847497563
1992,7966,5389,0,1,17,88,71,1,-5.55894310211814
1992,10475,5389,0,-7,-11,78,89,0,-8.98655464675715
1992,5253,5452,0,7,7,61,54,1,12.1268474975653
1992,2885,5520,0,11,10,78,68,1,6.62230252127622
1992,6636,5658,0,15,27,83,56,1,33.2371075338909
1992,417,5756,0,11,11,80,69,1,18.3238815585451
1992,1786,5985,0,-1,21,86,65,1,0.999043876489036
1992,2211,6121,0,7,-8,73,81,0,2.83360523375158
1992,9409,6121,0,11,7,85,78,1,11.4003565408849
1992,9443,6121,0,-1,-8,73,81,0,-3.95506030525351
1992,80,6288,0,-1,-9,55,64,0,-4.60964484399177
1992,5185,6288,0,-9,-5,63,68,0,-9.74547710721433
1992,6636,6288,0,3,7,80,73,1,6.28259563037542
1992,1786,6636,0,-8,-23,55,78,0,-9.48844579020484
1992,5219,6636,0,-5,4,75,71,1,-5.85378609908937
1992,5658,6636,0,-15,-27,56,83,0,-33.2371075338883
1992,6288,6636,0,-3,-7,73,80,0,-6.28259563037088
1992,9443,6671,0,-9,4,87,83,1,-15.0862899430255
1992,3055,6705,0,-13,-27,73,100,0,-18.6505345896569
1992,5219,6705,0,-4,3,75,72,1,-3.37816669634047
1992,9140,6705,0,-8,-16,71,87,0,-10.4634995492238
1992,4271,6739,0,13,19,88,69,1,24.563019003487
1992,5084,6973,0,5,10,80,70,1,3.12975589572772
1992,8669,7140,0,5,8,51,43,1,4.43805258809509
1992,9409,7432,0,15,20,73,53,1,24.086421547709
1992,2347,7966,0,3,12,81,69,1,10.550666394444
1992,4305,7966,0,-9,-2,76,78,0,-5.4620726323369
1992,5389,7966,0,-1,-17,71,88,0,5.55894310211507
1992,3139,8178,0,5,15,75,60,1,4.9641370633601
1992,9140,8412,0,-3,4,61,57,1,-4.31797246056097
1992,80,8582,0,7,5,80,75,1,-2.95255347262479
1992,4982,8669,0,3,6,77,71,1,5.45916424103768
1992,7140,8669,0,-5,-8,43,51,0,-4.4380525880959
1992,5219,8753,0,5,7,73,66,1,8.17194348071078
1992,3927,8889,0,-1,6,98,92,1,6.74947581332196
1992,6705,9140,0,8,16,87,71,1,10.4634995492263
1992,8412,9140,0,3,-4,57,61,0,4.31797246055952
1992,3825,9409,0,-1,27,106,79,1,9.10413594686795
1992,4603,9409,0,-7,-16,69,85,0,-8.29734767365223
1992,6121,9409,0,-11,-7,78,85,0,-11.4003565408846
1992,7432,9409,0,-15,-20,53,73,0,-24.0864215477094
1992,6121,9443,0,1,8,81,73,1,3.95506030525459
1992,6671,9443,0,9,-4,83,87,0,15.0862899430237
1992,9670,9477,0,13,30,84,54,1,14.2185601487118
1992,3241,9670,0,-5,1,79,78,1,4.17687217707168
1992,9477,9670,0,-13,-30,54,84,0,-14.2185601487104
1992,1455,9854,0,5,2,69,67,1,7.94002216109135
1992,2648,9854,0,1,-5,50,55,0,0.339679389095938
1992,4156,9854,0,8,-6,60,66,0,13.9787570181728
1992,4603,10339,0,1,23,81,58,1,-1.96020671672354
1992,5389,10475,0,7,11,89,78,1,8.98655464675231
1993,7836,296,0,-13,3,64,61,1,-20.6290509550031
1993,3533,418,0,-9,-30,64,94,0,-13.5848754167657
1993,6289,418,0,3,6,80,74,1,11.8829438492215
1993,8413,418,0,-1,-6,74,80,0,-4.1910495929419
1993,4157,596,0,13,22,94,72,1,20.7694532124291
1993,9960,738,0,11,20,92,72,1,19.3238889923739
1993,4157,1055,0,5,14,90,76,1,9.22332242148992
1993,8067,1055,0,-3,-9,71,80,0,-5.48278795839837
1993,2348,1147,0,3,-5,77,82,0,13.6893058297488
1993,4157,1147,0,4,17,93,76,1,9.74771736590454
1993,4740,1147,0,-5,-2,64,66,0,-2.25854659278138
1993,10340,1388,0,7,23,81,58,1,9.63018934812304
1993,1820,1456,0,-13,-27,66,93,0,-25.0266270957934
1993,6122,1456,0,-5,-37,55,92,0,-12.6221598532666
1993,6289,1456,0,1,7,75,68,1,7.34030720765135
1993,10062,1456,0,-4,-17,54,71,0,-7.03410568052364
1993,5220,1590,0,15,32,84,52,1,25.8507955031429
1993,1456,1820,0,13,27,93,66,1,25.0266270958028
1993,4604,2124,0,9,6,76,70,1,15.4838872396809
1993,1147,2348,0,-3,5,82,77,1,-13.6893058297479
1993,7548,2348,0,-11,-35,70,105,0,-16.0771358802479
1993,6289,2552,0,15,20,85,65,1,31.157656171568
1993,2886,2649,0,11,12,82,70,1,9.06172043713405
1993,2649,2886,0,-11,-12,70,82,0,-9.06172043713652
1993,4272,2886,0,2,25,106,81,1,7.23198800713335
1993,9141,2886,0,-8,-31,63,94,0,-8.9855484622692
1993,10232,2886,0,-4,-3,78,81,0,-2.640233713431
1993,5220,3022,0,11,8,72,64,1,11.1081305952111
1993,6088,3022,0,7,-14,68,82,0,-1.37767333090611
1993,8247,3022,0,-1,-10,80,90,0,-10.2691126118298
1993,8247,3242,0,-9,15,93,78,1,-12.9047932974878
1993,418,3533,0,9,30,94,64,1,13.5848754167618
1993,4488,3753,0,-5,-3,72,75,0,-3.68209582534344
1993,9960,3753,0,3,17,85,68,1,7.46601482067564
1993,4157,3826,0,-1,6,83,77,1,-3.72845555032759
1993,4604,3826,0,-3,-13,69,82,0,-11.2004540426963
1993,10726,3826,0,-15,-43,54,97,0,-21.8485314073342
1993,10794,3826,0,-8,-3,70,73,0,-16.211805628092
1993,9478,3928,0,-9,-13,69,82,0,-12.3312080235734
1993,10340,3928,0,-1,6,84,78,1,-3.28228541049342
1993,9410,3962,0,-1,11,81,70,1,-9.18769621249616
1993,596,4157,0,-13,-22,72,94,0,-20.7694532124244
1993,1055,4157,0,-5,-14,76,90,0,-9.22332242149105
1993,1147,4157,0,-4,-17,76,93,0,-9.74771736590774
1993,3826,4157,0,1,-6,77,83,0,3.72845555031982
1993,6289,4157,0,1,10,78,68,1,6.6632122046999
1993,9141,4191,0,-5,2,55,53,1,-1.55413292452875
1993,2886,4272,0,-2,-25,81,106,0,-7.23198800712653
1993,5220,4272,0,0,3,81,78,1,-2.82551659359857
1993,7399,4272,0,-15,-44,52,96,0,-30.0662994589084
1993,9773,4272,0,-7,-21,62,83,0,-11.6524073391353
1993,10340,4272,0,-4,-34,69,103,0,-8.17506357830688
1993,3753,4488,0,5,3,75,72,1,3.68209582534042
1993,2124,4604,0,-9,-6,70,76,0,-15.4838872396794
1993,3826,4604,0,3,13,82,69,1,11.2004540426901
1993,6706,4604,0,-1,-15,63,78,0,0.573602017923612
1993,1147,4740,0,5,2,66,64,1,2.25854659277999
1993,10062,4813,0,5,12,78,66,1,11.0391533956167
1993,6706,4881,0,7,12,74,62,1,-0.950301769509984
1993,6906,4983,0,-11,-4,50,54,0,-8.64611470421279
1993,10062,4983,0,-3,15,71,56,1,-0.491705695189296
1993,10232,5085,0,3,3,55,52,1,2.63586209803092
1993,1590,5220,0,-15,-32,52,84,0,-25.850795503143
1993,3022,5220,0,-11,-8,64,72,0,-11.1081305952096
1993,4272,5220,0,0,-3,78,81,0,2.82551659360576
1993,6289,5220,0,0,6,77,71,1,6.5218851671283
1993,8754,5220,0,-6,-5,72,77,0,-10.38301606846
1993,9410,5220,0,-8,-2,84,86,0,-11.7580661491918
1993,8754,5390,0,3,14,75,61,1,-2.48739041821698
1993,6122,5986,0,3,14,93,79,1,-2.70057525493565
1993,3022,6088,0,-7,14,82,68,1,1.37767333090622
1993,1456,6122,0,5,37,92,55,1,12.6221598532751
1993,5986,6122,0,-3,-14,79,93,0,2.70057525493583
1993,10794,6156,0,-1,18,73,55,1,-3.29423993905949
1993,418,6289,0,-3,-6,74,80,0,-11.882943849224
1993,1456,6289,0,-1,-7,68,75,0,-7.3403072076423
1993,2552,6289,0,-15,-20,65,85,0,-31.157656171567
1993,4157,6289,0,-1,-10,68,78,0,-6.66321220469932
1993,5220,6289,0,0,-6,71,77,0,-6.52188516712561
1993,7297,6289,0,-7,-45,67,112,0,-18.6732712350239
1993,4604,6706,0,1,15,78,63,1,-0.573602017923715
1993,4881,6706,0,-7,-12,62,74,0,0.950301769512354
1993,4983,6906,0,11,4,54,50,1,8.64611470421711
1993,9773,7008,0,1,21,86,65,1,3.30474395952621
1993,7297,7209,0,1,6,74,68,1,-3.29853571937496
1993,6289,7297,0,7,45,112,67,1,18.6732712350265
1993,7209,7297,0,-1,-6,68,74,0,3.2985357193759
1993,4272,7399,0,15,44,96,52,1,30.0662994589131
1993,2348,7548,0,11,35,105,70,1,16.0771358802512
1993,296,7836,0,13,-3,61,64,0,20.6290509550035
1993,8754,7836,0,8,11,68,57,1,11.3397718665953
1993,8822,7967,0,-13,-22,59,81,0,-20.5633187466059
1993,10232,7967,0,-5,4,72,68,1,-4.23211722779471
1993,1055,8067,0,3,9,80,71,1,5.48278795839613
1993,3022,8247,0,1,10,90,80,1,10.2691126118293
1993,3242,8247,0,9,-15,78,93,0,12.9047932974852
1993,418,8413,0,1,6,80,74,1,4.19104959293911
1993,8992,8413,0,-7,-18,67,85,0,-8.92935200476078
1993,5220,8754,0,6,5,77,72,1,10.3830160684606
1993,5390,8754,0,-3,-14,61,75,0,2.48739041821614
1993,7836,8754,0,-8,-11,57,68,0,-11.3397718665975
1993,9960,8754,0,4,-8,59,67,0,7.97743332271897
1993,7967,8822,0,13,22,81,59,1,20.5633187466045
1993,8413,8992,0,7,18,85,67,1,8.92935200476089
1993,2886,9141,0,8,31,94,63,1,8.98554846226947
1993,4191,9141,0,5,-2,53,55,0,1.55413292453001
1993,3962,9410,0,1,-11,70,81,0,9.18769621250024
1993,5220,9410,0,8,2,86,84,1,11.7580661491945
1993,3928,9478,0,9,13,82,69,1,12.3312080235758
1993,4272,9773,0,7,21,83,62,1,11.6524073391395
1993,7008,9773,0,-1,-21,65,86,0,-3.30474395952853
1993,738,9960,0,-11,-20,72,92,0,-19.3238889923747
1993,3753,9960,0,-3,-17,68,85,0,-7.46601482067781
1993,8754,9960,0,-4,8,67,59,1,-7.97743332272005
1993,1456,10062,0,4,17,71,54,1,7.03410568053208
1993,4813,10062,0,-5,-12,66,78,0,-11.0391533956189
1993,4983,10062,0,3,-15,56,71,0,0.491705695193343
1993,2886,10232,0,4,3,81,78,1,2.64023371343268
1993,5085,10232,0,-3,-3,52,55,0,-2.63586209802926
1993,7967,10232,0,5,-4,68,72,0,4.23211722779323
1993,1388,10340,0,-7,-23,58,81,0,-9.63018934812412
1993,3928,10340,0,1,-6,78,84,0,3.28228541049526
1993,4272,10340,0,4,34,103,69,1,8.17506357831171
1993,3826,10726,0,15,43,97,54,1,21.8485314073266
1993,3826,10794,0,8,3,73,70,1,16.2118056280844
1993,6156,10794,0,1,-18,55,73,0,3.29423993906164
1994,7176,82,0,1,-6,70,76,0,10.2462260769385
1994,7210,82,0,8,10,83,73,1,11.8643616509714
1994,419,297,0,1,9,91,82,1,-0.00283151969039608
1994,4605,297,0,-1,-12,70,82,0,-4.51466236449606
1994,4673,297,0,-13,-26,55,81,0,-27.1501618698026
1994,5391,297,0,1,-20,72,92,0,-8.59806552504148
1994,10063,297,0,-5,-13,58,71,0,-14.369293158673
1994,297,419,0,-1,-9,82,91,0,0.00283151968247353
1994,2349,419,0,-1,-4,72,76,0,-5.14359551608757
1994,3141,419,0,-8,-12,73,85,0,-6.25642459032537
1994,5221,419,0,-2,-8,68,76,0,-5.65426378805266
1994,5893,419,0,-15,-15,79,94,0,-34.7602868043046
1994,9176,419,0,-11,-19,84,103,0,-13.7070945504178
1994,4605,739,0,11,9,67,58,1,17.5137984419209
1994,2788,773,0,6,8,74,66,1,-0.922371290810776
1994,3827,773,0,4,-9,68,77,0,-0.975328312908019
1994,6290,773,0,8,-3,72,75,0,6.40104357694316
1994,10409,773,0,1,-3,64,67,0,-2.98371213428975
1994,10511,1148,0,-7,4,61,57,1,-5.39990749047366
1994,4158,1389,0,9,29,102,73,1,17.7452614228224
1994,10673,1457,0,-1,8,80,72,1,-0.40349104498144
1994,10341,1618,0,7,10,68,58,1,9.33941899570615
1994,2788,1788,0,-1,9,69,60,1,-7.68677250200233
1994,3023,1788,0,-8,-12,63,75,0,-14.496631872599
1994,7400,1788,0,-13,-18,46,64,0,-24.6347976829314
1994,8755,2315,0,9,22,61,39,1,14.0072026146973
1994,419,2349,0,1,4,76,72,1,5.14359551607842
1994,2788,2349,0,-1,-5,65,70,0,-2.83939233856561
1994,4882,2349,0,-4,-10,49,59,0,-3.6353940997983
1994,5255,2349,0,-5,-11,74,85,0,-2.84484818629476
1994,7210,2349,0,1,-9,60,69,0,2.91892826122812
1994,9244,2349,0,-13,-12,70,82,0,-24.9741658049649
1994,773,2788,0,-6,-8,66,74,0,0.922371290809203
1994,1788,2788,0,1,-9,60,69,0,7.68677250200582
1994,2349,2788,0,1,5,70,65,1,2.8393923385612
1994,4124,2788,0,-11,-2,62,64,0,-14.0253912447479
1994,6907,2788,0,-8,-12,58,70,0,-10.5043253467418
1994,1788,3023,0,8,12,75,63,1,14.4966318726019
1994,9278,3023,0,3,-5,46,51,0,6.23143888665446
1994,419,3141,0,8,12,85,73,1,6.25642459032321
1994,3754,3141,0,1,-7,77,84,0,1.79373961846731
1994,8671,3447,0,9,14,92,78,1,16.8345870548203
1994,3141,3754,0,-1,7,84,77,1,-1.79373961846387
1994,773,3827,0,-4,9,77,68,1,0.975328312901592
1994,6604,3827,0,-7,-12,72,84,0,-3.7626271151936
1994,8755,3827,0,1,-9,58,67,0,1.77274419888039
1994,2788,4124,0,11,2,64,62,1,14.0253912447515
1994,1389,4158,0,-9,-29,73,102,0,-17.7452614228259
1994,7210,4158,0,3,5,83,78,1,1.21683468800971
1994,10341,4158,0,-1,-11,58,69,0,-6.35295059008336
1994,4882,4273,0,-3,12,75,63,1,-7.40731438660323
1994,8823,4273,0,-11,-13,70,83,0,-22.550025667212
1994,6290,4439,0,15,20,71,51,1,30.1886344955742
1994,297,4605,0,1,12,82,70,1,4.51466236448963
1994,739,4605,0,-11,-9,58,67,0,-17.513798441924
1994,5289,4605,0,-3,-5,55,60,0,0.072600166798626
1994,297,4673,0,13,26,81,55,1,27.150161869798
1994,2349,4882,0,4,10,59,49,1,3.63539409979363
1994,4273,4882,0,3,-12,63,75,0,7.40731438660878
1994,9445,4882,0,-5,-22,59,81,0,-8.58180247534097
1994,4984,4950,0,8,-8,87,95,0,3.68047834775611
1994,5221,4950,0,7,7,78,71,1,4.64360834725183
1994,8482,4950,0,3,-8,66,74,0,-0.381825831047227
1994,4950,4984,0,-8,8,95,87,1,-3.68047834775628
1994,8959,4984,0,-13,-18,60,78,0,-17.2591227093248
1994,419,5221,0,2,8,76,68,1,5.65426378804772
1994,4950,5221,0,-7,-7,71,78,0,-4.64360834725331
1994,6975,5221,0,-11,-4,74,78,0,-8.95456482712805
1994,8891,5221,0,-3,-5,79,84,0,-3.57751864568131
1994,2349,5255,0,5,11,85,74,1,2.84484818628694
1994,7968,5255,0,-3,-11,73,84,0,-1.61963896374111
1994,4605,5289,0,3,5,60,55,1,-0.0726001667969243
1994,7549,5289,0,-5,-14,60,74,0,-12.4002613751005
1994,297,5391,0,-1,20,92,72,1,8.59806552504042
1994,5859,5391,0,-15,-23,53,76,0,-22.9334098389055
1994,8671,5391,0,-3,-10,88,98,0,3.54885489258616
1994,10673,5391,0,-8,-13,96,109,0,0.0779054971267819
1994,5391,5859,0,15,23,76,53,1,22.9334098389093
1994,419,5893,0,15,15,94,79,1,34.760286804302
1994,6907,5987,0,-5,10,90,80,1,-8.74423110748707
1994,10063,6089,0,3,3,57,54,1,-0.619413176724395
1994,6707,6123,0,9,10,65,55,1,11.4853292681099
1994,773,6290,0,-8,3,75,72,1,-6.40104357694316
1994,4439,6290,0,-15,-20,51,71,0,-30.1886344955718
1994,3827,6604,0,7,12,84,72,1,3.76262711519145
1994,6123,6707,0,-9,-10,55,65,0,-11.485329268108
1994,9176,6707,0,-8,2,82,80,1,-7.82063849814243
1994,2788,6907,0,8,12,70,58,1,10.5043253467441
1994,5987,6907,0,5,-10,80,90,0,8.74423110748863
1994,5221,6975,0,11,4,78,74,1,8.95456482712714
1994,82,7176,0,-1,6,76,70,1,-10.2462260769343
1994,82,7210,0,-8,-10,73,83,0,-11.8643616509708
1994,2349,7210,0,-1,9,69,60,1,-2.91892826123594
1994,4158,7210,0,-3,-5,78,83,0,-1.21683468801556
1994,9377,7210,0,-15,-31,67,98,0,-27.5909698558162
1994,1788,7400,0,13,18,64,46,1,24.6347976829335
1994,5289,7549,0,5,14,74,60,1,12.4002613751043
1994,5255,7968,0,3,11,84,73,1,1.61963896373951
1994,4950,8482,0,-3,8,74,66,1,0.381825831048349
1994,3447,8671,0,-9,-14,78,92,0,-16.8345870548201
1994,5391,8671,0,3,10,98,88,1,-3.5488548925829
1994,10511,8671,0,-8,-5,59,64,0,-9.30366196255921
1994,2315,8755,0,-9,-22,39,61,0,-14.0072026146984
1994,3827,8755,0,-1,9,67,58,1,-1.77274419888503
1994,4273,8823,0,11,13,83,70,1,22.550025667217
1994,5221,8891,0,3,5,84,79,1,3.57751864567847
1994,10233,8891,0,-5,-14,77,91,0,-5.87919857857906
1994,4984,8959,0,13,18,78,60,1,17.2591227093246
1994,419,9176,0,11,19,103,84,1,13.7070945504149
1994,6707,9176,0,8,-2,80,82,0,7.82063849814335
1994,9411,9176,0,7,-10,102,112,0,7.04922929969404
1994,2349,9244,0,13,12,82,70,1,24.9741658049595
1994,3023,9278,0,-3,5,51,46,1,-6.23143888665471
1994,7210,9377,0,15,31,98,67,1,27.5909698558141
1994,9176,9411,0,-7,10,112,102,1,-7.04922929969342
1994,4882,9445,0,5,22,81,59,1,8.58180247534157
1994,297,10063,0,5,13,71,58,1,14.3692931586685
1994,6089,10063,0,-3,-3,54,57,0,0.619413176724335
1994,8891,10233,0,5,14,91,77,1,5.87919857857786
1994,1618,10341,0,-7,-10,58,68,0,-9.33941899570675
1994,4158,10341,0,1,11,69,58,1,6.35295059007973
1994,773,10409,0,-1,3,67,64,1,2.98371213428617
1994,1148,10511,0,7,-4,57,61,0,5.3999074904718
1994,8671,10511,0,8,5,64,59,1,9.30366196255997
1994,1457,10673,0,1,-8,72,80,0,0.403491044982722
1994,5391,10673,0,8,13,109,96,1,-0.0779054971240001
1995,6708,83,0,1,14,66,52,1,5.563505880444
1995,6908,83,0,-7,-6,85,91,0,-7.19107248130865
1995,5188,298,0,-7,9,71,62,1,-11.1911041387039
1995,598,332,0,-7,-15,66,81,0,-12.3335034203277
1995,4274,332,0,4,24,97,73,1,10.6891049602128
1995,4815,332,0,-8,-10,54,64,0,-8.93923103332936
1995,5087,420,0,-4,-5,91,96,0,-2.85232061182047
1995,6291,420,0,0,-7,68,75,0,6.74658541418545
1995,8672,420,0,-5,-2,94,96,0,-1.22838675255478
1995,9245,420,0,-13,-1,78,79,0,-16.6020774947718
1995,9412,420,0,1,11,89,78,1,6.88783897859654
1995,10064,420,0,-2,-7,61,68,0,3.81022055420204
1995,332,598,0,7,15,81,66,1,12.3335034203282
1995,9143,1057,0,-1,6,76,70,1,-2.29670152137008
1995,8585,1356,0,-3,2,70,68,1,4.97544152096901
1995,1789,1390,0,13,29,100,71,1,19.5168689199558
1995,1789,1458,0,5,5,96,91,1,0.0736899999187273
1995,8756,1458,0,-3,-6,71,77,0,-6.05225478945712
1995,4159,1653,0,15,14,82,68,1,29.620299808846
1995,1390,1789,0,-13,-29,71,100,0,-19.5168689199538
1995,1458,1789,0,-5,-5,91,96,0,-0.0736899999165246
1995,4951,1789,0,-1,-10,89,99,0,4.38408796829098
1995,9412,1789,0,1,6,102,96,1,5.14030459872042
1995,6708,2316,0,9,24,73,49,1,15.3977248190796
1995,3964,2789,0,3,3,64,61,1,1.72752675917428
1995,9412,2854,0,15,36,92,56,1,34.038711714299
1995,6291,3142,0,4,10,74,64,1,12.1291740746985
1995,10444,3142,0,-8,-2,51,53,0,-3.09287467413214
1995,10796,3142,0,-5,-5,63,68,0,-0.800081012609752
1995,4951,3278,0,11,24,87,63,1,13.7118551711284
1995,9177,3755,0,5,6,68,62,1,0.149916035935068
1995,5392,3828,0,1,5,65,60,1,-3.80339028255992
1995,2789,3964,0,-3,-3,61,64,0,-1.72752675917831
1995,6291,3964,0,5,22,73,51,1,6.14602762705042
1995,1653,4159,0,-15,-14,68,82,0,-29.6202998088453
1995,10064,4159,0,-3,9,67,58,1,-3.12527501699415
1995,10234,4159,0,-7,-5,70,75,0,-16.4335136005842
1995,332,4274,0,-4,-24,73,97,0,-10.6891049602079
1995,5691,4274,0,-15,-46,67,113,0,-34.5940849054877
1995,6291,4274,0,-1,13,74,61,1,-4.69574717034986
1995,9143,4274,0,-8,-22,60,82,0,-18.4175210125374
1995,9775,4490,0,9,12,76,64,1,11.8596599352552
1995,5087,4606,0,5,21,77,56,1,1.62948696223044
1995,332,4815,0,8,10,64,54,1,8.93923103333354
1995,6674,4815,0,9,-10,67,77,0,7.4478537306304
1995,1789,4951,0,1,10,99,89,1,-4.38408796828789
1995,3278,4951,0,-11,-24,63,87,0,-13.711855171126
1995,8892,4951,0,-8,-14,68,82,0,-7.11065252876805
1995,6708,4985,0,-2,14,68,54,1,-1.86730798363881
1995,8551,4985,0,-13,-17,51,68,0,-25.6927816394343
1995,8585,4985,0,-8,-22,53,75,0,-9.16060359189318
1995,9177,4985,0,-4,-25,51,76,0,-10.7206304724873
1995,420,5087,0,4,5,96,91,1,2.85232061181988
1995,4606,5087,0,-5,-21,56,77,0,-1.62948696223301
1995,7211,5087,0,3,-2,73,75,0,0.0811925519278596
1995,298,5188,0,7,-9,62,71,0,11.1911041387141
1995,10064,5188,0,8,6,60,54,1,11.4807894496838
1995,10234,5222,0,1,6,82,76,1,-3.26086876063839
1995,10444,5256,0,-11,7,79,72,1,-10.2930017276923
1995,8483,5290,0,-1,3,64,61,1,3.01323413987591
1995,7838,5358,0,-7,-8,67,75,0,-7.24303502360901
1995,9412,5358,0,4,19,86,67,1,6.08732601277676
1995,9775,5358,0,1,-14,64,78,0,-0.560072974109843
1995,3828,5392,0,-1,-5,60,65,0,3.80339028255661
1995,9412,5392,0,7,1,75,74,1,11.9464476973787
1995,4274,5691,0,15,46,113,67,1,34.5940849054895
1995,6291,5759,0,13,10,80,70,1,26.6218034053015
1995,10342,5894,0,15,32,79,47,1,33.378402978352
1995,10064,6224,0,9,24,96,72,1,16.7674441522948
1995,420,6291,0,0,7,75,68,1,-6.74658541418326
1995,3142,6291,0,-4,-10,64,74,0,-12.1291740747004
1995,3964,6291,0,-5,-22,51,73,0,-6.14602762705142
1995,4274,6291,0,1,-13,61,74,0,4.69574717035194
1995,5759,6291,0,-13,-10,70,80,0,-26.6218034053012
1995,4815,6674,0,-9,10,77,67,1,-7.44785373063159
1995,83,6708,0,-1,-14,52,66,0,-5.56350588044322
1995,2316,6708,0,-9,-24,49,73,0,-15.3977248190834
1995,4985,6708,0,2,-14,54,68,0,1.86730798363162
1995,9412,6708,0,3,13,74,61,1,2.17431690496265
1995,10342,6708,0,3,-5,66,71,0,-2.26417927711201
1995,9177,6742,0,8,12,64,52,1,8.97792359302252
1995,10030,6742,0,11,-8,81,89,0,13.3908463773789
1995,8892,6806,0,-5,17,90,73,1,-0.180097464278223
1995,83,6908,0,7,6,91,85,1,7.19107248131156
1995,5087,7211,0,-3,2,75,73,1,-0.0811925519304673
1995,10512,7211,0,-11,-1,48,49,0,-9.48686059036351
1995,8672,7550,0,3,4,96,92,1,7.55912119478908
1995,5358,7838,0,7,8,75,67,1,7.24303502360863
1995,5290,8483,0,1,-3,61,64,0,-3.01323413987512
1995,10342,8483,0,8,5,64,59,1,1.87269149782258
1995,4985,8551,0,13,17,68,51,1,25.6927816394304
1995,1356,8585,0,3,-2,68,70,0,-4.9754415209694
1995,4985,8585,0,8,22,75,53,1,9.16060359188993
1995,420,8672,0,5,2,96,94,1,1.22838675255499
1995,7550,8672,0,-3,-4,92,96,0,-7.55912119479148
1995,1458,8756,0,3,6,77,71,1,6.05225478945858
1995,4951,8892,0,8,14,82,68,1,7.11065252876993
1995,6806,8892,0,5,-17,73,90,0,0.18009746427779
1995,1057,9143,0,1,-6,70,76,0,2.2967015213679
1995,4274,9143,0,8,22,82,60,1,18.4175210125377
1995,3755,9177,0,-5,-6,62,68,0,-0.149916035937878
1995,4985,9177,0,4,25,76,51,1,10.720630472482
1995,6742,9177,0,-8,-12,52,64,0,-8.97792359302463
1995,420,9245,0,13,1,79,78,1,16.6020774947733
1995,420,9412,0,-1,-11,78,89,0,-6.88783897859398
1995,1789,9412,0,-1,-6,96,102,0,-5.14030459871862
1995,2854,9412,0,-15,-36,56,92,0,-34.0387117142994
1995,5358,9412,0,-4,-19,67,86,0,-6.08732601277545
1995,5392,9412,0,-7,-1,74,75,0,-11.9464476973803
1995,6708,9412,0,-3,-13,61,74,0,-2.17431690496441
1995,4490,9775,0,-9,-12,64,76,0,-11.8596599352563
1995,5358,9775,0,-1,14,78,64,1,0.560072974109005
1995,6742,10030,0,-11,8,89,81,1,-13.3908463773801
1995,420,10064,0,2,7,68,61,1,-3.81022055420281
1995,4159,10064,0,3,-9,58,67,0,3.12527501699101
1995,5188,10064,0,-8,-6,54,60,0,-11.4807894496859
1995,6224,10064,0,-9,-24,72,96,0,-16.7674441522971
1995,4159,10234,0,7,5,75,70,1,16.4335136005826
1995,5222,10234,0,-1,-6,76,82,0,3.26086876063756
1995,5894,10342,0,-15,-32,47,79,0,-33.3784029783532
1995,6708,10342,0,-3,5,71,66,1,2.26417927710889
1995,8483,10342,0,-8,-5,59,64,0,-1.87269149782325
1995,3142,10444,0,8,2,53,51,1,3.09287467412939
1995,5256,10444,0,11,-7,72,79,0,10.2930017276942
1995,7211,10512,0,11,1,49,48,1,9.48686059036264
1995,3142,10796,0,5,5,68,63,1,0.800081012606594
1996,3931,299,0,-3,-14,73,87,0,2.69917786447362
1996,4160,299,0,1,3,83,80,1,3.58429985762919
1996,9929,299,0,-11,-39,51,90,0,-21.489752807128
1996,4884,421,0,8,-9,56,65,0,4.18646270695886
1996,4986,421,0,11,16,79,63,1,9.75566571827184
1996,6943,421,0,7,-6,80,86,0,7.54360844405325
1996,3245,565,0,11,11,90,79,1,18.2376884457379
1996,3245,775,0,8,14,103,89,1,0.399891535551948
1996,3829,775,0,5,-13,51,64,0,1.60831991406451
1996,8586,877,0,-1,8,66,58,1,5.01940601731056
1996,3965,1150,0,7,10,74,64,1,-1.94468365328482
1996,9776,1218,0,9,29,72,43,1,17.1386358589403
1996,3245,1459,0,-1,-17,70,87,0,-5.28842708905506
1996,5359,1459,0,-3,10,73,63,1,-8.29071313435912
1996,8757,1459,0,-5,-13,65,78,0,-12.532578063426
1996,9572,1459,0,-13,-5,61,66,0,-25.5730702805777
1996,3177,1527,0,1,7,81,74,1,4.91377945776365
1996,1790,1654,0,15,9,68,59,1,32.8676559974799
1996,1654,1790,0,-15,-9,59,68,0,-32.8676559974821
1996,2487,1790,0,-8,-14,81,95,0,-16.7143497203541
1996,5359,1790,0,-4,5,60,55,1,-12.964751652615
1996,5088,2317,0,7,-12,63,75,0,4.25039979993966
1996,8673,2317,0,8,11,69,58,1,7.30138089451352
1996,2487,2351,0,-1,15,75,60,1,-6.46524298670974
1996,1790,2487,0,8,14,95,81,1,16.7143497203503
1996,2351,2487,0,1,-15,60,75,0,6.46524298670406
1996,3931,3025,0,5,2,81,79,1,11.5996398570691
1996,4986,3143,0,1,24,86,62,1,-3.01383310695409
1996,5662,3143,0,-13,-37,56,93,0,-28.5250418071841
1996,6091,3143,0,-5,-11,62,73,0,-12.3482036792828
1996,8995,3143,0,-1,-8,90,98,0,-9.02750301376715
1996,1527,3177,0,-1,-7,74,81,0,-4.91377945775681
1996,7212,3177,0,7,-7,69,76,0,0.117235544281893
1996,8673,3177,0,4,2,83,81,1,-0.68676553831639
1996,565,3245,0,-11,-11,79,90,0,-18.2376884457307
1996,775,3245,0,-8,-14,89,103,0,-0.399891535545105
1996,1459,3245,0,1,17,87,70,1,5.28842708905757
1996,775,3829,0,-5,13,64,51,1,-1.60831991405942
1996,299,3931,0,3,14,87,73,1,-2.6991778644713
1996,3025,3931,0,-5,-2,79,81,0,-11.5996398570723
1996,1150,3965,0,-7,-10,64,74,0,1.94468365328315
1996,9776,3965,0,1,6,73,67,1,8.16722935424501
1996,299,4160,0,-1,-3,80,83,0,-3.58429985762214
1996,7504,4160,0,-13,-38,54,92,0,-25.6110465434727
1996,7839,4160,0,-8,-25,51,76,0,-11.9013223441045
1996,8673,4160,0,-2,3,60,57,1,-2.9910155684934
1996,6091,4194,0,3,21,69,48,1,2.5218607598516
1996,4986,4275,0,0,-7,74,81,0,-10.6201974393849
1996,7771,4275,0,-15,-38,72,110,0,-33.8383088497111
1996,8673,4275,0,-3,-9,67,76,0,-13.0515829412375
1996,9776,4275,0,-3,-31,70,101,0,-12.1807070617824
1996,10099,4275,0,-8,-24,60,84,0,-19.9664941821788
1996,10343,4275,0,-1,-20,63,83,0,-11.5481690848467
1996,9178,4607,0,-5,-2,80,82,0,-2.11858547843078
1996,10031,4607,0,3,-4,64,68,0,5.73103466556922
1996,10343,4607,0,4,1,60,59,1,4.56764588508759
1996,421,4884,0,-8,9,65,56,1,-4.18646270696206
1996,5490,4884,0,-9,-24,44,68,0,-16.0729704603083
1996,7839,4952,0,-3,12,91,79,1,-7.0734607122612
1996,421,4986,0,-11,-16,63,79,0,-9.75566571827144
1996,3143,4986,0,-1,-24,62,86,0,3.01383310695048
1996,4275,4986,0,0,7,81,74,1,10.6201974393888
1996,8586,4986,0,-8,-5,74,79,0,-5.53435916309292
1996,9379,4986,0,-15,-22,70,92,0,-30.8529116447561
1996,2317,5088,0,-7,12,75,63,1,-4.25039979994266
1996,8893,5223,0,-3,4,80,76,1,-3.86933203299374
1996,1459,5359,0,3,-10,63,73,0,8.29071313435996
1996,1790,5359,0,4,-5,55,60,0,12.9647516526145
1996,7144,5359,0,-8,-22,41,63,0,-12.3156905770741
1996,8673,5359,0,1,8,77,69,1,3.37453780948258
1996,9895,5359,0,-7,-7,51,58,0,-7.19854388509102
1996,4884,5490,0,9,24,68,44,1,16.0729704603068
1996,8673,5558,0,9,33,88,55,1,9.36622639917197
1996,3143,5662,0,13,37,93,56,1,28.5250418071782
1996,8995,5821,0,11,1,74,73,1,10.1524532409931
1996,3143,6091,0,5,11,73,62,1,12.3482036792744
1996,4194,6091,0,-3,-21,48,69,0,-2.52186075985706
1996,6292,6159,0,5,21,83,62,1,12.4455300134035
1996,6159,6292,0,-5,-21,62,83,0,-12.4455300134027
1996,8995,6292,0,3,19,92,73,1,-4.49801993418247
1996,8757,6675,0,3,18,61,43,1,-3.13878498187804
1996,421,6943,0,-7,6,86,80,1,-7.54360844405735
1996,10031,7045,0,11,34,92,58,1,17.8285189770773
1996,5359,7144,0,8,22,63,41,1,12.3156905770751
1996,9413,7144,0,9,-2,41,43,0,12.5697391919788
1996,3177,7212,0,-7,7,76,69,1,-0.117235544279467
1996,10167,7212,0,-15,-2,71,73,0,-24.2386926617508
1996,4160,7504,0,13,38,92,54,1,25.6110465434721
1996,4275,7771,0,15,38,110,72,1,33.8383088497132
1996,4160,7839,0,8,25,76,51,1,11.9013223441043
1996,4952,7839,0,3,-12,79,91,0,7.07346071225974
1996,877,8586,0,1,-8,58,66,0,-5.0194060173053
1996,4986,8586,0,8,5,79,74,1,5.5343591630954
1996,2317,8673,0,-8,-11,58,69,0,-7.30138089451456
1996,3177,8673,0,-4,-2,81,83,0,0.686765538317786
1996,4160,8673,0,2,-3,57,60,0,2.9910155684923
1996,4275,8673,0,3,9,76,67,1,13.0515829412384
1996,5359,8673,0,-1,-8,69,77,0,-3.37453780948182
1996,5558,8673,0,-9,-33,55,88,0,-9.36622639917257
1996,1459,8757,0,5,13,78,65,1,12.5325780634223
1996,6675,8757,0,-3,-18,43,61,0,3.13878498187732
1996,5223,8893,0,3,-4,76,80,0,3.86933203299568
1996,10343,8893,0,8,3,65,62,1,7.36002662194138
1996,3143,8995,0,1,8,98,90,1,9.02750301376079
1996,5821,8995,0,-11,-1,73,74,0,-10.1524532409931
1996,6292,8995,0,-3,-19,73,92,0,4.49801993418258
1996,4607,9178,0,5,2,82,80,1,2.11858547843004
1996,4986,9379,0,15,22,92,70,1,30.8529116447588
1996,7144,9413,0,-9,2,43,41,1,-12.5697391919792
1996,10343,9481,0,13,12,62,50,1,22.4547429077241
1996,1459,9572,0,13,5,66,61,1,25.5730702805772
1996,1218,9776,0,-9,-29,43,72,0,-17.1386358589397
1996,3965,9776,0,-1,-6,67,73,0,-8.16722935424595
1996,4275,9776,0,3,31,101,70,1,12.1807070617839
1996,5359,9895,0,7,7,58,51,1,7.19854388509246
1996,299,9929,0,11,39,90,51,1,21.4897528071352
1996,4607,10031,0,-3,4,68,64,1,-5.73103466557121
1996,7045,10031,0,-11,-34,58,92,0,-17.8285189770781
1996,4275,10099,0,8,24,84,60,1,19.9664941821803
1996,10513,10099,0,1,-13,48,61,0,-2.50522745837512
1996,7212,10167,0,15,2,73,71,1,24.2386926617514
1996,4275,10343,0,1,20,83,63,1,11.5481690848495
1996,4607,10343,0,-4,-1,59,60,0,-4.56764588508711
1996,8893,10343,0,-8,-3,62,65,0,-7.36002662193939
1996,9481,10343,0,-13,-12,50,62,0,-22.454742907723
1996,10099,10513,0,-1,13,61,48,1,2.5052274583751
1997,1621,300,0,-8,-4,69,73,0,-16.8896946492309
1997,4161,300,0,3,-3,82,85,0,6.06903950606767
1997,4276,300,0,3,-5,79,84,0,8.26415809306511
1997,6293,300,0,3,-8,58,66,0,2.20932107166371
1997,7179,300,0,-6,-4,92,96,0,-8.78639022217122
1997,8105,300,0,-9,-8,57,65,0,-17.7113856553272
1997,8451,776,0,1,4,81,77,1,1.10440271282584
1997,9930,776,0,-7,-7,66,73,0,-8.02093767979798
1997,9179,810,0,7,29,81,52,1,11.3449055261936
1997,1460,1025,0,11,17,86,69,1,13.255310145629
1997,6293,1151,0,4,6,63,57,1,6.31489384300361
1997,7145,1151,0,-7,-3,52,55,0,-10.4635201465682
1997,10032,1151,0,1,-7,68,75,0,-0.714953275598024
1997,9414,1324,0,13,34,109,75,1,22.3557922491428
1997,3144,1358,0,-3,-12,67,79,0,-0.0558256946517872
1997,9777,1358,0,5,19,77,58,1,6.1595957249275
1997,3178,1392,0,11,-3,70,73,0,12.9406454044192
1997,3757,1392,0,8,-12,63,75,0,14.8774446962703
1997,7179,1392,0,4,6,71,65,1,11.7721835143612
1997,1025,1460,0,-11,-17,69,86,0,-13.2553101456227
1997,3966,1460,0,-3,1,67,66,1,-8.32194644585828
1997,5190,1528,0,-9,-12,56,68,0,-8.60147976773762
1997,5292,1528,0,3,6,90,84,1,5.17612060554605
1997,9179,1528,0,-1,-6,59,65,0,-3.07932131612573
1997,300,1621,0,8,4,73,69,1,16.8896946492334
1997,4953,1621,0,7,-9,66,75,0,14.2429408178906
1997,3830,1689,0,1,-18,62,80,0,5.29330009963558
1997,6293,1689,0,8,17,73,56,1,14.515563640272
1997,8139,1824,0,13,-13,65,78,0,18.6888964769237
1997,8894,1824,0,5,1,82,81,1,15.6684814402306
1997,5761,2352,0,-13,-3,68,71,0,-29.8642774068837
1997,7179,2352,0,-8,11,98,87,1,-11.7294850701311
1997,6293,2721,0,15,8,82,74,1,29.6991018266816
1997,1358,3144,0,3,12,79,67,1,0.0558256946531373
1997,1392,3178,0,-11,3,73,70,1,-12.9406454044171
1997,1392,3757,0,-8,12,75,63,1,-14.8774446962689
1997,9675,3757,0,-5,-13,77,90,0,-1.95754799798501
1997,3966,3791,0,5,12,69,57,1,1.54570774367926
1997,1689,3830,0,-1,18,80,62,1,-5.29330009963569
1997,4276,3932,0,7,6,75,69,1,13.6314704978328
1997,10066,3932,0,-1,-13,60,73,0,-1.1954546892195
1997,1460,3966,0,3,-1,66,67,0,8.32194644586838
1997,3791,3966,0,-5,-12,57,69,0,-1.54570774367378
1997,9414,3966,0,4,1,74,73,1,3.15805940224896
1997,4161,4036,0,15,14,78,64,1,40.0293566047979
1997,300,4161,0,-3,3,85,82,1,-6.0690395060628
1997,4036,4161,0,-15,-14,64,78,0,-40.0293566047984
1997,7213,4161,0,-7,-14,61,75,0,-15.8843464483569
1997,300,4276,0,-3,5,84,79,1,-8.26415809305733
1997,3932,4276,0,-7,-6,69,75,0,-13.6314704978291
1997,5292,4276,0,0,-9,69,78,0,-6.88500921988722
1997,5525,4276,0,-15,-38,54,92,0,-28.6287801653023
1997,8451,4276,0,-3,-15,68,83,0,-16.9101146320514
1997,9777,4276,0,-1,-13,59,72,0,-12.5762717189077
1997,10032,4526,0,9,10,101,91,1,13.1797312497763
1997,4987,4608,0,-5,-8,57,65,0,-0.714450412584098
1997,6092,4608,0,3,-1,63,64,0,3.15671014677656
1997,6293,4608,0,5,23,97,74,1,11.9281661434331
1997,8894,4608,0,-4,-15,63,78,0,1.01479666576738
1997,7179,4885,0,-3,22,81,59,1,-1.6148098837939
1997,1621,4953,0,-7,9,75,66,1,-14.2429408178915
1997,4608,4987,0,5,8,65,57,1,0.714450412580826
1997,1528,5190,0,9,12,68,56,1,8.60147976773083
1997,1528,5292,0,-3,-6,84,90,0,-5.17612060554833
1997,4276,5292,0,0,9,78,69,1,6.8850092198918
1997,8758,5292,0,-8,-19,57,76,0,-8.25957847552609
1997,8962,5292,0,-15,-32,46,78,0,-30.3823718475847
1997,9414,5292,0,-1,-8,72,80,0,-6.97971894312808
1997,8758,5326,0,-1,22,62,40,1,2.21655504260883
1997,4276,5525,0,15,38,92,54,1,28.6287801653051
1997,2352,5761,0,13,3,71,68,1,29.8642774068787
1997,9777,5862,0,13,14,75,61,1,21.0721320325994
1997,4608,6092,0,-3,1,64,63,1,-3.15671014678006
1997,6744,6092,0,-11,-4,55,59,0,-11.3603700865138
1997,300,6293,0,-3,8,66,58,1,-2.20932107165732
1997,1151,6293,0,-4,-6,57,63,0,-6.31489384300381
1997,1689,6293,0,-8,-17,56,73,0,-14.5155636402736
1997,2721,6293,0,-15,-8,74,82,0,-29.6991018266792
1997,4608,6293,0,-5,-23,74,97,0,-11.9281661434335
1997,8587,6676,0,5,13,80,67,1,5.33186177054033
1997,6092,6744,0,11,4,59,55,1,11.3603700865131
1997,8451,6876,0,9,10,75,65,1,3.87779159988374
1997,1151,7145,0,7,3,55,52,1,10.4635201465677
1997,300,7179,0,6,4,96,92,1,8.78639022217804
1997,1392,7179,0,-4,-6,65,71,0,-11.7721835143597
1997,2352,7179,0,8,-11,87,98,0,11.7294850701276
1997,4885,7179,0,3,-22,59,81,0,1.6148098838007
1997,4161,7213,0,7,14,75,61,1,15.8843464483569
1997,7301,7213,0,-1,-7,76,83,0,5.22970037700664
1997,7213,7301,0,1,7,83,76,1,-5.22970037700559
1997,300,8105,0,9,8,65,57,1,17.7113856553328
1997,1824,8139,0,-13,13,78,65,1,-18.6888964769219
1997,776,8451,0,-1,-4,77,81,0,-1.10440271282452
1997,4276,8451,0,3,15,83,68,1,16.9101146320526
1997,6876,8451,0,-9,-10,65,75,0,-3.8777915998867
1997,10344,8519,0,11,22,68,46,1,18.3023600062787
1997,6676,8587,0,-5,-13,67,80,0,-5.33186177054093
1997,9777,8587,0,4,5,82,77,1,-2.24440480424745
1997,10344,8587,0,3,-6,66,72,0,2.36398661724869
1997,5292,8758,0,8,19,76,57,1,8.25957847552711
1997,5326,8758,0,1,-22,40,62,0,-2.21655504260823
1997,1824,8894,0,-5,-1,81,82,0,-15.66848144023
1997,4608,8894,0,4,15,78,63,1,-1.01479666576893
1997,10676,8894,0,3,-13,58,71,0,0.734810359161877
1997,5292,8962,0,15,32,78,46,1,30.3823718475857
1997,810,9179,0,-7,-29,52,81,0,-11.3449055261919
1997,1528,9179,0,1,6,65,59,1,3.07932131612198
1997,1324,9414,0,-13,-34,75,109,0,-22.3557922491427
1997,3966,9414,0,-4,-1,73,74,0,-3.15805940224497
1997,5292,9414,0,1,8,80,72,1,6.97971894313071
1997,10798,9414,0,-5,-13,83,96,0,0.597371289537882
1997,3757,9675,0,5,13,90,77,1,1.9575479979877
1997,1358,9777,0,-5,-19,58,77,0,-6.15959572492962
1997,4276,9777,0,1,13,72,59,1,12.5762717189115
1997,5862,9777,0,-13,-14,61,75,0,-21.0721320325978
1997,8587,9777,0,-4,-5,77,82,0,2.24440480424743
1997,776,9930,0,7,7,73,66,1,8.02093767980071
1997,10798,9964,0,3,12,80,68,1,4.2627808149685
1997,1151,10032,0,-1,7,75,68,1,0.714953275596443
1997,4526,10032,0,-9,-10,91,101,0,-13.1797312497758
1997,3932,10066,0,1,13,73,60,1,1.19545468922046
1997,8519,10344,0,-11,-22,46,68,0,-18.3023600062796
1997,8587,10344,0,-3,6,72,66,1,-2.36398661724943
1997,8894,10676,0,-3,13,71,58,1,-0.734810359160992
1997,9414,10798,0,5,13,96,83,1,-0.597371289537087
1997,9964,10798,0,-3,-12,68,80,0,-4.26278081496785
1998,3792,301,0,-8,-33,49,82,0,-14.0426886683232
1998,4954,301,0,-3,-8,79,87,0,-5.56205229216184
1998,6227,301,0,-15,-39,60,99,0,-29.407362831853
1998,9778,301,0,-2,25,76,51,1,-9.81193082967275
1998,5991,423,0,-5,-9,65,74,0,-7.45009519069351
1998,9778,423,0,3,6,75,69,1,-1.58756850031532
1998,6093,1026,0,9,17,79,62,1,9.56964811989661
1998,3724,1359,0,-1,-15,62,77,0,-1.87964258445451
1998,6294,1359,0,7,10,93,83,1,15.1825674886714
1998,6419,1461,0,-13,-3,62,65,0,-12.1657117334921
1998,10481,1461,0,-8,1,75,74,1,-2.92594837349703
1998,10271,1529,0,-5,3,75,72,1,-7.07112965208301
1998,8588,1622,0,11,10,67,57,1,13.9562223048511
1998,2688,1792,0,-13,-8,85,93,0,-18.6549667924646
1998,3831,1792,0,-5,-10,68,78,0,-6.90696965408763
1998,6294,1792,0,1,11,75,64,1,5.71039525708336
1998,10379,1792,0,-9,-1,74,75,0,-12.1421144545747
1998,5225,2061,0,11,19,80,61,1,19.6954524118078
1998,7214,2129,0,13,39,95,56,1,21.3737588608733
1998,7214,2251,0,8,15,80,65,1,10.1161005861324
1998,8418,2251,0,3,-2,64,66,0,1.11089422694808
1998,4277,2353,0,-1,2,86,84,1,-8.15242694612295
1998,6711,2353,0,-7,-6,73,79,0,-16.7853501067244
1998,7268,2353,0,-15,-36,63,99,0,-35.2720983545998
1998,8675,2353,0,-4,-13,67,80,0,-19.0797256234067
1998,5259,2489,0,9,12,83,71,1,11.9139763742532
1998,1792,2688,0,13,8,93,85,1,18.654966792458
1998,8725,2891,0,7,-9,87,96,0,9.62677394749514
1998,9931,2891,0,-1,6,83,77,1,-12.9805182810982
1998,6711,3027,0,1,15,74,59,1,3.17347524721612
1998,1359,3724,0,1,15,77,62,1,1.87964258445275
1998,4954,3758,0,1,6,67,61,1,3.7752526756185
1998,8106,3758,0,-7,-13,51,64,0,-7.29767071226689
1998,301,3792,0,8,33,82,49,1,14.042688668329
1998,8793,3792,0,1,-1,81,82,0,0.73266937907756
1998,1792,3831,0,5,10,78,68,1,6.90696965408533
1998,6677,3831,0,-3,-7,87,94,0,-4.7224324654866
1998,8675,3899,0,7,2,63,61,1,2.74421601411602
1998,7101,4162,0,-15,-58,52,110,0,-38.9808627388367
1998,7302,4162,0,-7,5,80,75,1,-11.1634662649483
1998,2353,4277,0,1,-2,84,86,0,8.15242694612189
1998,7506,4277,0,-13,-15,67,82,0,-28.4128109762169
1998,8486,4277,0,-8,-27,61,88,0,-12.7031872529399
1998,8588,4277,0,-1,-1,85,86,0,-3.97592587229386
1998,9415,4277,0,-4,-26,68,94,0,-9.19680785356688
1998,9778,4277,0,-1,-9,69,78,0,-7.55310389563556
1998,301,4954,0,3,8,87,79,1,5.56205229217241
1998,3758,4954,0,-1,-6,61,67,0,-3.77525267561749
1998,9812,4954,0,-9,-14,68,82,0,-12.7039826370302
1998,8486,4988,0,-3,5,51,46,1,-2.8479702725028
1998,9415,5157,0,5,3,65,62,1,2.31338654192989
1998,2061,5225,0,-11,-19,61,80,0,-19.6954524118057
1998,9415,5225,0,-3,3,85,82,1,-6.04700768580297
1998,2489,5259,0,-9,-12,71,83,0,-11.91397637425
1998,6294,5259,0,3,15,73,58,1,7.89841977384125
1998,7146,5259,0,-1,-7,56,63,0,-7.71043581052412
1998,9931,5327,0,-9,1,70,69,1,-17.8715769064189
1998,7302,5762,0,1,23,97,74,1,4.02987708836053
1998,6294,5863,0,15,36,88,52,1,30.3747663836398
1998,423,5991,0,5,9,74,65,1,7.45009519070037
1998,1026,6093,0,-9,-17,62,79,0,-9.56964811989662
1998,8675,6093,0,-1,10,56,46,1,-3.61256946264869
1998,301,6227,0,15,39,99,60,1,29.4073628318608
1998,1359,6294,0,-7,-10,83,93,0,-15.1825674886687
1998,1792,6294,0,-1,-11,64,75,0,-5.7103952570869
1998,5259,6294,0,-3,-15,58,73,0,-7.89841977383824
1998,5863,6294,0,-15,-36,52,88,0,-30.374766383637
1998,9778,6294,0,-2,6,65,59,1,-12.1585547045788
1998,1461,6419,0,13,3,65,62,1,12.1657117334856
1998,3831,6677,0,3,7,94,87,1,4.72243246549129
1998,2353,6711,0,7,6,79,73,1,16.785350106726
1998,3027,6711,0,-1,-15,59,74,0,-3.17347524721448
1998,4162,7101,0,15,58,110,52,1,38.9808627388365
1998,5259,7146,0,1,7,63,56,1,7.71043581052563
1998,9642,7146,0,-7,-12,57,69,0,-3.9290755832089
1998,2129,7214,0,-13,-39,56,95,0,-21.3737588608734
1998,2251,7214,0,-8,-15,65,80,0,-10.1161005861339
1998,8588,7214,0,-1,8,67,59,1,-2.0070368037713
1998,2353,7268,0,15,36,99,63,1,35.2720983546
1998,4162,7302,0,7,-5,75,80,0,11.1634662649487
1998,5762,7302,0,-1,-23,74,97,0,-4.02987708836127
1998,8588,7302,0,5,2,79,77,1,6.53859029401784
1998,9931,7302,0,-5,-6,68,74,0,-11.6804605861165
1998,8140,7370,0,11,-1,61,62,0,6.19336999499598
1998,10379,7370,0,3,15,81,66,1,2.4673809795093
1998,4277,7506,0,13,15,82,67,1,28.4128109762153
1998,9778,7739,0,11,17,85,68,1,6.56298641701103
1998,3758,8106,0,7,13,64,51,1,7.29767071226533
1998,7370,8140,0,-11,1,62,61,1,-6.19336999499573
1998,2251,8418,0,-3,2,66,64,1,-1.11089422694938
1998,4277,8486,0,8,27,88,61,1,12.7031872529383
1998,4988,8486,0,3,-5,46,51,0,2.847970272505
1998,1622,8588,0,-11,-10,57,67,0,-13.9562223048526
1998,4277,8588,0,1,1,86,85,1,3.97592587229209
1998,7214,8588,0,1,-8,59,67,0,2.00703680377096
1998,7302,8588,0,-5,-2,77,79,0,-6.53859029401847
1998,10271,8588,0,-8,-18,65,83,0,-7.70525629172584
1998,2353,8675,0,4,13,80,67,1,19.0797256234067
1998,3899,8675,0,-7,-2,61,63,0,-2.7442160141142
1998,6093,8675,0,1,-10,46,56,0,3.61256946264682
1998,2891,8725,0,-7,9,96,87,1,-9.62677394749235
1998,10481,8759,0,-3,30,82,52,1,1.66505902188217
1998,3792,8793,0,-1,1,82,81,1,-0.732669379079997
1998,4277,9415,0,4,26,94,68,1,9.19680785356445
1998,5157,9415,0,-5,-3,62,65,0,-2.31338654193015
1998,5225,9415,0,3,-3,82,85,0,6.04700768580567
1998,7146,9642,0,7,12,69,57,1,3.92907558320997
1998,301,9778,0,2,-25,51,76,0,9.81193082968043
1998,423,9778,0,-3,-6,69,75,0,1.58756850032469
1998,4277,9778,0,1,9,78,69,1,7.55310389563485
1998,6294,9778,0,2,-6,59,65,0,12.1585547045816
1998,7739,9778,0,-11,-17,68,85,0,-6.56298641700936
1998,10481,9778,0,-7,-3,62,65,0,0.529869251932379
1998,4954,9812,0,9,14,82,68,1,12.7039826370329
1998,2891,9931,0,1,-6,77,83,0,12.9805182810996
1998,5327,9931,0,9,-1,69,70,0,17.8715769064211
1998,7302,9931,0,5,6,74,68,1,11.6804605861165
1998,1529,10271,0,5,-3,72,75,0,7.07112965208109
1998,8588,10271,0,8,18,83,65,1,7.70525629172518
1998,1792,10379,0,9,1,75,74,1,12.1421144545689
1998,7370,10379,0,-3,-15,66,81,0,-2.46738097951039
1998,10799,10379,0,5,-1,68,69,0,11.0249494529763
1998,1461,10481,0,8,-1,74,75,0,2.92594837349157
1998,8759,10481,0,3,-30,52,82,0,-1.66505902188191
1998,9778,10481,0,7,3,65,62,1,-0.529869251931483
1998,10379,10799,0,-5,1,69,68,1,-11.0249494529759
1999,8589,193,0,13,12,69,57,1,26.8472067640848
1999,6678,302,0,-9,1,61,60,1,-3.31501589121412
1999,3934,424,0,-1,10,82,72,1,1.32449440007102
1999,8039,424,0,-9,-14,80,94,0,-11.2051177483964
1999,9779,458,0,13,22,80,58,1,14.6611792002249
1999,6643,527,0,-3,8,72,64,1,-7.66526332006979
1999,6712,527,0,-8,-7,74,81,0,-13.3521708969488
1999,10644,527,0,-15,-39,41,80,0,-31.4660947594638
1999,6678,1360,0,-8,13,85,72,1,1.89395934001229
1999,7303,1360,0,-7,-11,70,81,0,-0.916680888911532
1999,3112,1462,0,-11,-24,48,72,0,-15.2828323806903
1999,8760,1462,0,-3,10,64,54,1,-3.87942684485366
1999,9181,1623,0,-1,9,62,53,1,4.73391814182257
1999,2354,1793,0,0,-3,74,77,0,10.5164567500921
1999,3282,1793,0,-9,-5,62,67,0,-10.9119316226399
1999,3934,1793,0,-4,-10,68,78,0,-10.0387672506033
1999,6094,1793,0,-8,-22,56,78,0,-16.7545752073565
1999,6643,1793,0,-3,-6,58,64,0,-7.08422750346034
1999,9745,1793,0,-15,-25,66,91,0,-31.4733316832382
1999,4610,1894,0,3,-4,58,62,0,4.11159351385199
1999,4955,1894,0,8,12,75,63,1,15.506774679815
1999,8794,2130,0,9,10,62,52,1,14.0612965145626
1999,6643,2252,0,8,31,75,44,1,9.34396072383654
1999,9416,2252,0,7,-3,53,56,0,7.6740168106795
1999,1793,2354,0,0,3,77,74,1,-10.5164567500957
1999,2827,2354,0,-15,-41,58,99,0,-50.1182306346328
1999,5260,2354,0,0,-6,62,68,0,-12.8090572358232
1999,5459,2354,0,-11,-17,61,78,0,-23.3518698939183
1999,8760,2354,0,-5,-21,64,85,0,-19.0151375472834
1999,9181,2354,0,-8,-41,56,97,0,-24.1076525121906
1999,4163,2655,0,5,21,95,74,1,9.80866223599394
1999,3282,2793,0,-4,1,73,72,1,-2.33581731361639
1999,6912,2793,0,-5,-14,61,75,0,-9.62180289038202
1999,10448,2793,0,-8,-8,74,82,0,-11.4563381801624
1999,2354,2827,0,15,41,99,58,1,50.1182306346366
1999,3832,3028,0,5,20,108,88,1,5.91798271454978
1999,1462,3112,0,11,24,72,48,1,15.2828323806945
1999,1793,3282,0,9,5,67,62,1,10.9119316226323
1999,2793,3282,0,4,-1,72,73,0,2.3358173136168
1999,5294,3282,0,3,-12,63,75,0,0.0699273660260182
1999,8589,3282,0,8,-8,74,82,0,9.60381862943162
1999,3028,3832,0,-5,-20,88,108,0,-5.91798271454941
1999,8419,3832,0,3,25,86,61,1,4.64099340715165
1999,424,3934,0,1,-10,72,82,0,-1.32449440007574
1999,1793,3934,0,4,10,78,68,1,10.0387672505946
1999,9283,3934,0,-7,-13,64,77,0,-5.62096667688588
1999,2655,4163,0,-5,-21,74,95,0,-9.80866223599993
1999,4278,4163,0,3,4,92,88,1,7.59831004893004
1999,8760,4244,0,5,7,61,54,1,9.25558916179391
1999,4163,4278,0,-3,-4,88,92,0,-7.5983100489322
1999,5192,4278,0,-7,-15,43,58,0,-12.0900980432187
1999,5260,4278,0,2,7,73,66,1,-0.783569748112065
1999,6128,4278,0,-11,-22,60,82,0,-20.7468586442098
1999,5158,4346,0,13,21,75,54,1,19.8805871516379
1999,1894,4610,0,-3,4,62,58,1,-4.11159351384395
1999,1894,4955,0,-8,-12,63,75,0,-15.5067746798084
1999,8419,4955,0,-1,14,76,62,1,-5.03263587650261
1999,9932,4955,0,-13,-22,60,82,0,-22.6113174472858
1999,4346,5158,0,-13,-21,54,75,0,-19.8805871516397
1999,7215,5158,0,-8,10,73,63,1,-4.14379602707332
1999,4278,5192,0,7,15,58,43,1,12.0900980432181
1999,9779,5192,0,8,-8,58,66,0,7.10082101637623
1999,10380,5192,0,3,-1,58,59,0,0.860822179380719
1999,2354,5260,0,0,6,68,62,1,12.8090572358269
1999,4278,5260,0,-2,-7,66,73,0,0.783569748113084
1999,5328,5260,0,-8,-8,66,74,0,-7.22453628723837
1999,5695,5260,0,-15,-23,53,76,0,-30.0397622181585
1999,6678,5260,0,-12,-8,46,54,0,-9.92667437595417
1999,3282,5294,0,-3,12,75,63,1,-0.0699273660252615
1999,5260,5328,0,8,8,74,66,1,7.22453628724114
1999,10034,5328,0,1,-2,70,72,0,-3.07344170407315
1999,6094,5396,0,-1,2,61,59,1,-4.39931469207944
1999,2354,5459,0,11,17,78,61,1,23.3518698939233
1999,8794,5459,0,8,-30,51,81,0,3.75924598495853
1999,10678,5459,0,7,-11,32,43,0,5.6377645272107
1999,5260,5695,0,15,23,76,53,1,30.0397622181584
1999,6643,5763,0,9,14,72,58,1,10.8130229862358
1999,1793,6094,0,8,22,78,56,1,16.7545752073505
1999,5396,6094,0,1,-2,59,61,0,4.39931469208222
1999,4278,6128,0,11,22,82,60,1,20.7468586442091
1999,10448,6295,0,-11,2,76,74,1,-12.6394463559675
1999,527,6643,0,3,-8,64,72,0,7.66526332005727
1999,1793,6643,0,3,6,64,58,1,7.08422750345127
1999,2252,6643,0,-8,-31,44,75,0,-9.34396072383889
1999,5763,6643,0,-9,-14,58,72,0,-10.8130229862389
1999,8419,6643,0,1,-3,74,77,0,4.26828474550504
1999,302,6678,0,9,-1,60,61,0,3.3150158912188
1999,1360,6678,0,8,-13,72,85,0,-1.89395934001614
1999,5260,6678,0,12,8,54,46,1,9.92667437595376
1999,527,6712,0,8,7,81,74,1,13.3521708969368
1999,8676,6712,0,1,-8,61,69,0,4.43399445444373
1999,2793,6912,0,5,14,75,61,1,9.62180289038296
1999,5158,7215,0,8,-10,63,73,0,4.14379602707185
1999,8760,7215,0,4,22,77,55,1,3.10073737019559
1999,8896,7215,0,3,-4,54,58,0,-2.88134660934722
1999,1360,7303,0,7,11,81,70,1,0.916680888910104
1999,8419,7639,0,11,26,69,43,1,21.5197296328312
1999,424,8039,0,9,14,94,80,1,11.2051177483936
1999,3832,8419,0,-3,-25,61,86,0,-4.64099340714729
1999,4955,8419,0,1,-14,62,76,0,5.03263587650398
1999,6643,8419,0,-1,3,77,74,1,-4.26828474550644
1999,7639,8419,0,-11,-26,43,69,0,-21.5197296328303
1999,193,8589,0,-13,-12,57,69,0,-26.8472067640873
1999,3282,8589,0,-8,8,82,74,1,-9.60381862943328
1999,6712,8676,0,-1,8,69,61,1,-4.43399445444419
1999,1462,8760,0,3,-10,54,64,0,3.87942684485886
1999,2354,8760,0,5,21,85,64,1,19.0151375472883
1999,4244,8760,0,-5,-7,54,61,0,-9.25558916179311
1999,7215,8760,0,-4,-22,55,77,0,-3.10073737019388
1999,2130,8794,0,-9,-10,52,62,0,-14.0612965145634
1999,5459,8794,0,-8,30,81,51,1,-3.75924598495807
1999,7215,8896,0,-3,4,58,54,1,2.88134660934703
1999,1623,9181,0,1,-9,53,62,0,-4.73391814182283
1999,2354,9181,0,8,41,97,56,1,24.1076525121933
1999,3934,9283,0,7,13,77,64,1,5.62096667688424
1999,2252,9416,0,-7,3,56,53,1,-7.67401681068016
1999,1793,9745,0,15,25,91,66,1,31.4733316832312
1999,458,9779,0,-13,-22,58,80,0,-14.6611792002225
1999,5192,9779,0,-8,8,66,58,1,-7.1008210163776
1999,4955,9932,0,13,22,82,60,1,22.6113174472868
1999,5328,10034,0,-1,2,72,70,1,3.07344170407514
1999,5192,10380,0,-3,1,59,58,1,-0.860822179381692
1999,2793,10448,0,8,8,82,74,1,11.4563381801634
1999,6295,10448,0,11,-2,74,76,0,12.6394463559696
1999,527,10644,0,15,39,80,41,1,31.466094759453
1999,5459,10678,0,-7,11,43,32,1,-5.6377645272095
2000,6644,269,0,11,26,87,61,1,14.8518760818912
2000,4039,303,0,-15,-24,47,71,0,-31.9818423274502
2000,10679,303,0,-7,7,66,59,1,-3.7195047387863
2000,5159,425,0,5,4,75,71,1,-1.7174400376967
2000,1895,528,0,-3,-3,69,72,0,-5.83614445731041
2000,3969,528,0,5,19,79,60,1,4.31946249023457
2000,9417,603,0,5,8,65,57,1,6.93782565867185
2000,2794,1028,0,7,1,69,68,1,11.2027670675315
2000,3969,1293,0,13,10,88,78,1,18.5030385533952
2000,9182,1463,0,-5,8,69,61,1,-6.0674413338023
2000,9610,1463,0,-13,-17,47,64,0,-23.1277787709923
2000,8795,1794,0,1,14,65,51,1,2.16705221330562
2000,9814,1794,0,-7,-8,67,75,0,-8.38705135080796
2000,528,1895,0,3,3,72,69,1,5.8361444573091
2000,7216,2097,0,5,1,62,61,1,6.79583261597805
2000,4164,2219,0,1,4,81,77,1,2.9506242814168
2000,2794,2355,0,-4,9,87,78,1,-3.16759635049998
2000,4164,2355,0,-7,-5,64,69,0,-8.32954529999926
2000,4381,2355,0,-15,-27,55,82,0,-32.570824580718
2000,1028,2794,0,-7,-1,68,69,0,-11.2027670675375
2000,2355,2794,0,4,-9,78,87,0,3.16759635049505
2000,3760,2794,0,1,-17,76,93,0,-2.58291693139243
2000,5261,2794,0,4,13,89,76,1,1.22099623391582
2000,6296,2794,0,-3,-12,59,71,0,-7.09876598440078
2000,6713,2794,0,2,-12,65,77,0,-2.63872333696261
2000,10679,2961,0,1,10,66,56,1,6.64173054673084
2000,4611,3283,0,3,-11,66,77,0,-0.635574113508827
2000,7216,3283,0,4,9,75,66,1,0.54556759541979
2000,8420,3283,0,8,-6,76,82,0,-1.70807899019247
2000,6713,3506,0,11,20,86,66,1,14.9725224433293
2000,2794,3760,0,-1,17,93,76,1,2.58291693138777
2000,6913,3760,0,-9,-10,58,68,0,-16.5715810925112
2000,6981,3833,0,-5,20,77,57,1,-8.09090145880807
2000,8897,3867,0,7,16,77,61,1,13.8242045565556
2000,4956,3901,0,11,15,74,59,1,20.727804848043
2000,528,3969,0,-5,-19,60,79,0,-4.31946249023565
2000,1293,3969,0,-13,-10,78,88,0,-18.5030385533968
2000,5261,3969,0,1,11,75,64,1,5.74372634366112
2000,9417,3969,0,-4,-24,56,80,0,-3.70872879193998
2000,303,4039,0,15,24,71,47,1,31.9818423274524
2000,2219,4164,0,-1,-4,77,81,0,-2.9506242814164
2000,2355,4164,0,7,5,69,64,1,8.32954529999568
2000,8318,4279,0,-7,-5,80,85,0,-9.51234532723684
2000,8677,4279,0,1,2,52,50,1,-1.22494326685827
2000,8761,4347,0,13,26,73,47,1,20.3300653748074
2000,2355,4381,0,15,27,82,55,1,32.570824580714
2000,3283,4611,0,-3,11,77,66,1,0.635574113500731
2000,7930,4747,0,-9,-3,61,64,0,-15.700799889794
2000,8897,4747,0,-1,-5,67,72,0,0.938823414370965
2000,10679,4747,0,-4,13,61,48,1,-3.83913953116795
2000,3901,4956,0,-11,-15,59,74,0,-20.7278048480483
2000,9417,4956,0,-3,35,105,70,1,-4.34605155791419
2000,425,5159,0,-5,-4,71,75,0,1.71744003769573
2000,6644,5159,0,3,-13,62,75,0,6.91537474461974
2000,9182,5159,0,-1,9,80,71,1,8.39902937041187
2000,2794,5261,0,-4,-13,76,89,0,-1.22099623391691
2000,3969,5261,0,-1,-11,64,75,0,-5.74372634366234
2000,8677,5261,0,-3,-17,58,75,0,-6.54722438935466
2000,9780,5261,0,-7,-12,61,73,0,-12.1983850648664
2000,9933,5261,0,-15,-27,38,65,0,-27.2467424320605
2000,10679,5261,0,-7,-12,41,53,0,-8.4442229932963
2000,6296,5397,0,1,14,84,70,1,2.98821882122546
2000,2794,6296,0,3,12,71,59,1,7.098765984403
2000,5397,6296,0,-1,-14,70,84,0,-2.98821882122429
2000,8590,6296,0,7,-7,53,60,0,11.0330492876791
2000,8795,6296,0,4,-5,69,74,0,3.32043859644986
2000,9182,6296,0,1,-4,55,59,0,3.33565001520945
2000,8420,6421,0,13,5,61,56,1,10.3030194798408
2000,269,6644,0,-11,-26,61,87,0,-14.8518760818947
2000,5159,6644,0,-3,13,75,62,1,-6.91537474462222
2000,7216,6679,0,-3,4,66,62,1,-2.72154812090568
2000,10645,6679,0,-11,-24,50,74,0,-20.1756339011725
2000,2794,6713,0,-2,12,77,65,1,2.63872333696364
2000,3506,6713,0,-11,-20,66,86,0,-14.9725224433295
2000,6981,6713,0,-8,-8,67,75,0,-8.18694610116143
2000,7974,6713,0,-7,-2,66,68,0,-10.6867931869042
2000,7974,6811,0,-3,1,72,71,1,-5.30556524598701
2000,3760,6913,0,9,10,68,58,1,16.5715810925084
2000,3833,6981,0,5,-20,57,77,0,8.09090145881438
2000,6713,6981,0,8,8,75,67,1,8.18694610116542
2000,2097,7216,0,-5,-1,61,62,0,-6.79583261598012
2000,3283,7216,0,-4,-9,66,75,0,-0.545567595421069
2000,6679,7216,0,3,-4,62,66,0,2.72154812091067
2000,10679,7216,0,-2,4,64,60,1,-0.826311810426493
2000,8590,7508,0,15,19,84,65,1,38.0336317679915
2000,8677,7640,0,9,14,79,65,1,14.5674142759976
2000,4747,7930,0,9,3,64,61,1,15.700799889795
2000,6713,7974,0,7,2,68,66,1,10.6867931869057
2000,6811,7974,0,3,-1,71,72,0,5.30556524598535
2000,8761,7974,0,8,-2,65,67,0,11.2181253319192
2000,4279,8318,0,7,5,85,80,1,9.51234532723686
2000,3283,8420,0,-8,6,82,76,1,1.70807899019087
2000,6421,8420,0,-13,-5,56,61,0,-10.3030194798397
2000,9780,8488,0,1,3,48,45,1,2.79395312281241
2000,6296,8590,0,-7,7,60,53,1,-11.033049287673
2000,7508,8590,0,-15,-19,65,84,0,-38.0336317679887
2000,4279,8677,0,-1,-2,50,52,0,1.22494326685838
2000,5261,8677,0,3,17,75,58,1,6.54722438935448
2000,7640,8677,0,-9,-14,65,79,0,-14.567414275998
2000,4347,8761,0,-13,-26,47,73,0,-20.3300653748065
2000,7974,8761,0,-8,2,67,65,1,-11.2181253319186
2000,1794,8795,0,-1,-14,51,65,0,-2.16705221330496
2000,6296,8795,0,-4,5,74,69,1,-3.32043859644704
2000,9451,8795,0,-9,-5,58,63,0,-17.4029098143359
2000,3867,8897,0,-7,-16,61,77,0,-13.8242045565549
2000,4747,8897,0,1,5,72,67,1,-0.938823414370791
2000,1463,9182,0,5,-8,61,69,0,6.06744133379861
2000,5159,9182,0,1,-9,71,80,0,-8.399029370413
2000,6296,9182,0,-1,4,59,55,1,-3.3356500152054
2000,9644,9182,0,-3,-27,62,89,0,-9.18391328928321
2000,603,9417,0,-5,-8,57,65,0,-6.93782565866618
2000,3969,9417,0,4,24,80,56,1,3.7087287919393
2000,4956,9417,0,3,-35,70,105,0,4.34605155790901
2000,8795,9451,0,9,5,63,58,1,17.4029098143359
2000,1463,9610,0,13,17,64,47,1,23.1277787709877
2000,9182,9644,0,3,27,89,62,1,9.18391328928498
2000,5261,9780,0,7,12,73,61,1,12.1983850648657
2000,8488,9780,0,-1,-3,45,48,0,-2.79395312281196
2000,1794,9814,0,7,8,75,67,1,8.38705135080894
2000,5261,9933,0,15,27,65,38,1,27.2467424320604
2000,6679,10645,0,11,24,74,50,1,20.1756339011764
2000,303,10679,0,7,-7,59,66,0,3.71950473878819
2000,2961,10679,0,-1,-10,56,66,0,-6.64173054672961
2000,4747,10679,0,4,-13,48,61,0,3.83913953116675
2000,5261,10679,0,7,12,53,41,1,8.44422299329557
2000,7216,10679,0,2,-4,60,64,0,0.826311810427544
2001,5262,142,0,15,34,69,35,1,34.2024514562166
2001,1029,304,0,-8,-21,52,73,0,-14.3115096481397
2001,2356,304,0,1,10,82,72,1,6.55789091594271
2001,2424,304,0,-13,-25,76,101,0,-24.9971893819321
2001,3761,304,0,1,-6,81,87,0,-3.59582648451755
2001,5262,304,0,1,-19,61,80,0,-0.480610592234822
2001,5330,304,0,-1,-10,56,66,0,-10.1555479716776
2001,3148,426,0,-3,2,63,61,1,-5.47593062514333
2001,8285,780,0,-11,-3,65,68,0,-16.2035736667984
2001,9679,780,0,-3,3,74,71,1,-3.20312450057693
2001,304,1029,0,8,21,73,52,1,14.311509648142
2001,10348,1029,0,3,-16,63,79,0,9.93197557923458
2001,1464,1063,0,7,25,84,59,1,3.40490875385724
2001,2962,1155,0,-1,12,82,70,1,0.611333404111257
2001,3761,1362,0,8,18,79,61,1,8.25149149129488
2001,8796,1362,0,1,-7,63,70,0,2.12824557585752
2001,1063,1464,0,-7,-25,59,84,0,-3.40490875385335
2001,4246,1464,0,-8,-23,43,66,0,-6.34989108963507
2001,8591,1464,0,4,13,78,65,1,11.1798716236907
2001,3936,1896,0,3,13,69,56,1,1.07089296877957
2001,4165,1969,0,9,24,99,75,1,13.5903238129748
2001,304,2356,0,-1,-10,72,82,0,-6.5578909159379
2001,4957,2356,0,-2,-11,84,95,0,-8.25969347538335
2001,5398,2356,0,-8,-13,81,94,0,-22.0003428993338
2001,5495,2356,0,-15,-43,52,95,0,-36.0519171605798
2001,9418,2356,0,-3,-13,63,76,0,-16.1841856166078
2001,9679,2356,0,-5,-10,69,79,0,-16.9778987762172
2001,304,2424,0,13,25,101,76,1,24.9971893819323
2001,8762,2795,0,-8,21,75,54,1,-8.03196046015416
2001,10240,2795,0,-11,-13,56,69,0,-13.8555227000139
2001,1155,2962,0,1,-12,70,82,0,-0.611333404114895
2001,5262,2962,0,8,16,81,65,1,9.91493792155891
2001,4957,3114,0,11,3,83,80,1,19.7830524722146
2001,426,3148,0,3,-2,61,63,0,5.47593062514658
2001,3346,3148,0,-5,-19,57,76,0,-16.0965787896814
2001,4957,3148,0,7,10,76,66,1,12.448198384033
2001,5398,3182,0,-1,2,70,68,1,-2.83385764714468
2001,4957,3216,0,8,19,79,60,1,19.2232808663719
2001,10680,3216,0,5,-1,49,50,0,10.1166367288586
2001,8455,3250,0,-1,4,66,62,1,-2.9173272815118
2001,3868,3284,0,-1,-17,68,85,0,-4.72259356318752
2001,5262,3284,0,11,15,77,62,1,13.5512292637051
2001,10070,3284,0,7,-1,85,86,0,7.63205582536919
2001,3148,3346,0,5,19,76,57,1,16.0965787896846
2001,3970,3346,0,13,-1,57,58,0,21.0727311799069
2001,8678,3454,0,7,10,79,69,1,4.63612732180958
2001,9418,3507,0,9,13,61,48,1,11.2404115750546
2001,4280,3541,0,13,4,72,68,1,22.1937978885315
2001,304,3761,0,-1,6,87,81,1,3.59582648451228
2001,1362,3761,0,-8,-18,61,79,0,-8.25149149130254
2001,4165,3761,0,-3,-16,64,80,0,-2.52219434271883
2001,6524,3761,0,-15,-42,54,96,0,-33.4159181736943
2001,4246,3834,0,-9,4,77,73,1,-9.1449513132216
2001,3284,3868,0,1,17,85,68,1,4.72259356318481
2001,6680,3868,0,9,-2,68,70,0,8.8930493318708
2001,5330,3902,0,11,2,72,70,1,16.060054301341
2001,1896,3936,0,-3,-13,56,69,0,-1.07089296878529
2001,4280,3936,0,5,13,92,79,1,7.29496721399227
2001,3346,3970,0,-13,1,58,57,1,-21.072731179907
2001,1969,4165,0,-9,-24,75,99,0,-13.5903238129747
2001,3761,4165,0,3,16,80,64,1,2.52219434271619
2001,8678,4165,0,-1,-29,58,87,0,-8.14223018548141
2001,1464,4246,0,8,23,66,43,1,6.34989108963822
2001,3834,4246,0,9,-4,73,77,0,9.14495131322109
2001,3541,4280,0,-13,-4,68,72,0,-22.193797888532
2001,3936,4280,0,-5,-13,79,92,0,-7.29496721399409
2001,9679,4280,0,-4,4,80,76,1,-5.77759154789875
2001,2356,4957,0,2,11,95,84,1,8.25969347538734
2001,3114,4957,0,-11,-3,80,83,0,-19.7830524722179
2001,3148,4957,0,-7,-10,66,76,0,-12.4481983840335
2001,3216,4957,0,-8,-19,60,79,0,-19.2232808663748
2001,8591,4957,0,2,-14,73,87,0,1.98615512250569
2001,142,5262,0,-15,-34,35,69,0,-34.2024514562151
2001,304,5262,0,-1,19,80,61,1,0.480610592235326
2001,2962,5262,0,-8,-16,65,81,0,-9.91493792155707
2001,3284,5262,0,-11,-15,62,77,0,-13.5512292637045
2001,8762,5262,0,-10,-7,62,69,0,-10.8627541943057
2001,304,5330,0,1,10,66,56,1,10.1555479716785
2001,3902,5330,0,-11,-2,70,72,0,-16.060054301339
2001,6558,5330,0,-3,-3,56,59,0,-1.59126587850858
2001,2356,5398,0,8,13,94,81,1,22.0003428993406
2001,3182,5398,0,1,-2,68,70,0,2.83385764714377
2001,2356,5495,0,15,43,95,52,1,36.0519171605856
2001,6948,6297,0,-5,8,82,74,1,-9.06059966735885
2001,7149,6297,0,-13,-22,48,70,0,-23.3674169544709
2001,3761,6524,0,15,42,96,54,1,33.4159181736892
2001,10646,6524,0,0,-4,67,71,0,7.95412103300897
2001,5330,6558,0,3,3,59,56,1,1.59126587851013
2001,10802,6558,0,-5,-12,71,83,0,-1.93081546422201
2001,9815,6645,0,-7,9,77,68,1,-6.04714291325901
2001,3868,6680,0,-9,2,70,68,1,-8.89304933187151
2001,9679,6714,0,5,15,69,54,1,4.12439905482693
2001,6297,6948,0,5,-8,74,82,0,9.06059966735555
2001,7183,6948,0,-3,-10,59,69,0,2.56923061256711
2001,8762,6948,0,-4,12,84,72,1,2.86846789801256
2001,6297,7149,0,13,22,70,48,1,23.367416954468
2001,6948,7183,0,3,10,69,59,1,-2.5692306125678
2001,780,8285,0,11,3,68,65,1,16.2035736667967
2001,3250,8455,0,1,-4,62,66,0,2.91732728150986
2001,8591,8455,0,8,7,90,83,1,14.0279415801506
2001,1464,8591,0,-4,-13,65,78,0,-11.1798716236901
2001,4957,8591,0,-2,14,87,73,1,-1.98615512250929
2001,8455,8591,0,-8,-7,83,90,0,-14.0279415801512
2001,9577,8591,0,-15,-29,60,89,0,-31.1697650735075
2001,3454,8678,0,-7,-10,69,79,0,-4.63612732181007
2001,4165,8678,0,1,29,87,58,1,8.14223018548199
2001,2795,8762,0,8,-21,54,75,0,8.03196046015742
2001,5262,8762,0,10,7,69,62,1,10.8627541943067
2001,6948,8762,0,4,-12,72,84,0,-2.86846789801341
2001,8898,8762,0,5,-14,65,79,0,0.221898732731145
2001,1362,8796,0,-1,7,70,63,1,-2.12824557585899
2001,8762,8898,0,-5,14,79,65,1,-0.221898732733077
2001,2356,9418,0,3,13,76,63,1,16.1841856166127
2001,3507,9418,0,-9,-13,48,61,0,-11.2404115750559
2001,9815,9418,0,-8,-25,50,75,0,-6.28007874244217
2001,8591,9577,0,15,29,89,60,1,31.1697650735058
2001,780,9679,0,3,-3,71,74,0,3.20312450057511
2001,2356,9679,0,5,10,79,69,1,16.9778987762234
2001,4280,9679,0,4,-4,76,80,0,5.7775915478985
2001,6714,9679,0,-5,-15,54,69,0,-4.12439905482469
2001,6645,9815,0,7,-9,68,77,0,6.04714291326065
2001,9418,9815,0,8,25,75,50,1,6.2800787424411
2001,3284,10070,0,-7,1,86,85,1,-7.63205582537019
2001,2795,10240,0,11,13,69,56,1,13.8555227000177
2001,1029,10348,0,-3,16,79,63,1,-9.93197557923137
2001,6524,10646,0,0,4,71,67,1,-7.95412103301126
2001,3216,10680,0,-5,1,50,49,1,-10.1166367288594
2001,6558,10802,0,5,12,83,71,1,1.93081546422204
2002,2751,90,0,-13,-8,78,86,0,-22.4596036561182
2002,4247,90,0,-8,13,71,58,1,-5.16146251154309
2002,8042,196,0,0,4,81,77,1,8.38464981453605
2002,6681,305,0,1,21,88,67,1,2.76302022689433
2002,7811,305,0,-11,-5,81,86,0,-12.2690716667858
2002,10769,305,0,-8,-8,60,68,0,-9.59517247984831
2002,8899,781,0,5,13,70,57,1,4.64615088909471
2002,1465,815,0,15,38,90,52,1,29.137896169801
2002,6915,1156,0,-5,-7,75,82,0,-5.96675139996591
2002,7017,1156,0,3,13,63,50,1,0.594834758963474
2002,7017,1295,0,11,17,71,54,1,15.6134404473156
2002,6559,1363,0,1,19,82,63,1,0.569281188746629
2002,815,1465,0,-15,-38,52,90,0,-29.1378961697968
2002,9419,1465,0,-7,4,105,101,1,-12.0529568098529
2002,3347,1796,0,-13,-11,67,78,0,-16.6096734342933
2002,4958,1796,0,1,8,90,82,1,6.36718674652558
2002,5946,1796,0,-5,-3,74,77,0,-0.53431667419515
2002,7557,1796,0,-9,-12,59,71,0,-6.85149297716092
2002,2796,1897,0,7,-1,82,83,0,15.2907290332236
2002,3762,1897,0,8,12,72,60,1,10.7005944693097
2002,6646,2065,0,9,5,69,64,1,16.7763916749542
2002,3835,2357,0,-4,1,74,73,1,-10.5775768188142
2002,6559,2357,0,-7,-7,77,84,0,-13.9253500308095
2002,10647,2357,0,-15,-47,37,84,0,-34.9543887306814
2002,90,2751,0,13,8,86,78,1,22.4596036561261
2002,1897,2796,0,-7,1,83,82,1,-15.2907290332246
2002,5766,3183,0,-11,-17,68,85,0,-14.5310953626431
2002,7557,3183,0,-8,2,77,75,1,-5.90794172659381
2002,10769,3285,0,-5,7,73,66,1,-6.08989811944429
2002,1796,3347,0,13,11,78,67,1,16.6096734342934
2002,10803,3455,0,3,12,70,58,1,3.79050291191429
2002,4166,3542,0,15,11,70,59,1,26.2701778114259
2002,6681,3728,0,13,8,71,63,1,20.0219457199127
2002,1897,3762,0,-8,-12,60,72,0,-10.7005944693085
2002,4166,3762,0,3,4,73,69,1,5.70386800298926
2002,7710,3762,0,-9,-29,64,93,0,-9.91261238054989
2002,2357,3835,0,4,-1,73,74,0,10.577576818813
2002,4247,3835,0,-5,-12,69,81,0,-5.49152782674218
2002,4958,3835,0,4,12,64,52,1,4.05441810946689
2002,6681,3835,0,3,-9,64,73,0,2.61243975826857
2002,9612,3835,0,-8,-9,67,76,0,-12.8332782288175
2002,9782,3835,0,-7,-19,56,75,0,-6.86266062694538
2002,3542,4166,0,-15,-11,59,70,0,-26.2701778114307
2002,3762,4166,0,-3,-4,69,73,0,-5.70386800299667
2002,4958,4166,0,0,9,97,88,1,-1.81636795437029
2002,6813,4166,0,-1,-18,86,104,0,-3.27393741543557
2002,8592,4166,0,-7,-23,63,86,0,-6.33665440694236
2002,90,4247,0,8,-13,58,71,0,5.16146251154794
2002,3835,4247,0,5,12,81,69,1,5.49152782673568
2002,6715,4247,0,3,-8,61,69,0,1.81633406056719
2002,7017,4247,0,7,-5,73,78,0,1.70909933910014
2002,4958,4281,0,3,10,78,68,1,2.9708027595249
2002,9184,4281,0,-8,-5,82,87,0,-7.01628168196992
2002,9935,4281,0,-9,-15,68,83,0,-9.76255228640452
2002,9184,4890,0,-7,2,71,69,1,-5.24636010571055
2002,1796,4958,0,-1,-8,82,90,0,-6.36718674652328
2002,3835,4958,0,-4,-12,52,64,0,-4.05441810946678
2002,4166,4958,0,0,-9,88,97,0,1.81636795436738
2002,4281,4958,0,-3,-10,68,78,0,-2.97080275952347
2002,8042,4958,0,-15,-15,70,85,0,-25.269561903468
2002,10681,4958,0,-7,-30,57,87,0,-12.0609355433637
2002,5365,5026,0,11,12,70,58,1,15.5510247974656
2002,5399,5161,0,-7,13,93,80,1,-0.39523784424583
2002,5946,5263,0,3,11,69,58,1,0.230433443618701
2002,9419,5331,0,1,22,80,58,1,-1.89664288054808
2002,5026,5365,0,-11,-12,58,70,0,-15.5510247974668
2002,8899,5365,0,-3,4,68,64,1,-1.15299477180498
2002,5161,5399,0,7,-13,80,93,0,0.395237844246338
2002,6646,5399,0,8,-16,67,83,0,4.02901959948067
2002,6681,5399,0,10,6,81,75,1,7.94673321414773
2002,9419,5399,0,4,-9,73,82,0,-0.2045095338973
2002,6813,5530,0,13,19,81,62,1,25.0236011473653
2002,3183,5766,0,11,17,85,68,1,14.5310953626398
2002,1796,5946,0,5,3,77,74,1,0.534316674194393
2002,5263,5946,0,-3,-11,58,69,0,-0.230433443620949
2002,1363,6559,0,-1,-19,63,82,0,-0.569281188744551
2002,2357,6559,0,7,7,84,77,1,13.9253500308109
2002,2065,6646,0,-9,-5,64,69,0,-16.7763916749539
2002,5399,6646,0,-8,16,83,67,1,-4.0290195994808
2002,305,6681,0,-1,-21,67,88,0,-2.76302022690169
2002,3728,6681,0,-13,-8,63,71,0,-20.0219457199146
2002,3835,6681,0,-3,9,73,64,1,-2.61243975827313
2002,5399,6681,0,-10,-6,75,81,0,-7.94673321414837
2002,10803,6681,0,-5,-13,65,78,0,-7.08775117177725
2002,4247,6715,0,-3,8,69,61,1,-1.81633406057215
2002,4166,6813,0,1,18,104,86,1,3.27393741542936
2002,5530,6813,0,-13,-19,62,81,0,-25.0236011473656
2002,8899,6813,0,-4,-2,70,72,0,-7.03921751790611
2002,10349,6813,0,-5,-5,87,92,0,-5.87496982322655
2002,1156,6915,0,5,7,82,75,1,5.96675139996912
2002,10349,6983,0,3,9,83,74,1,5.84968115441002
2002,1156,7017,0,-3,-13,50,63,0,-0.594834758956663
2002,1295,7017,0,-11,-17,54,71,0,-15.6134404473107
2002,4247,7017,0,-7,5,78,73,1,-1.70909933910046
2002,1796,7557,0,9,12,71,59,1,6.85149297716025
2002,3183,7557,0,8,-2,75,77,0,5.90794172659064
2002,9001,7557,0,5,-8,68,76,0,5.96143585931918
2002,3762,7710,0,9,29,93,64,1,9.91261238054751
2002,305,7811,0,11,5,86,81,1,12.2690716667807
2002,196,8042,0,0,-4,77,81,0,-8.38464981453271
2002,4958,8042,0,15,15,85,70,1,25.2695619034709
2002,10681,8422,0,1,10,80,70,1,2.20488698302214
2002,4166,8592,0,7,23,86,63,1,6.33665440693682
2002,10241,8592,0,-1,-16,68,84,0,-6.90200091482381
2002,781,8899,0,-5,-13,57,70,0,-4.64615088909773
2002,5365,8899,0,3,-4,64,68,0,1.15299477180252
2002,6813,8899,0,4,2,72,70,1,7.03921751790491
2002,7557,9001,0,-5,8,76,68,1,-5.96143585931805
2002,4281,9184,0,8,5,87,82,1,7.01628168196899
2002,4890,9184,0,7,-2,69,71,0,5.24636010570917
2002,1465,9419,0,7,-4,101,105,0,12.0529568098566
2002,5331,9419,0,-1,-22,58,80,0,1.89664288054636
2002,5399,9419,0,-4,9,82,73,1,0.20450953389804
2002,3835,9612,0,8,9,76,67,1,12.8332782288156
2002,9680,9612,0,9,-4,89,93,0,12.0725482047247
2002,9612,9680,0,-9,4,93,89,1,-12.0725482047246
2002,3835,9782,0,7,19,75,56,1,6.86266062694284
2002,4281,9935,0,9,15,83,68,1,9.76255228640326
2002,8592,10241,0,1,16,84,68,1,6.90200091482345
2002,6813,10349,0,5,5,92,87,1,5.87496982322724
2002,6983,10349,0,-3,-9,74,83,0,-5.84968115440794
2002,2357,10647,0,15,47,84,37,1,34.9543887306827
2002,4958,10681,0,7,30,87,57,1,12.0609355433665
2002,8422,10681,0,-1,-10,70,80,0,-2.20488698302204
2002,305,10769,0,8,8,68,60,1,9.59517247984281
2002,3285,10769,0,5,-7,66,73,0,6.08989811944066
2002,3455,10803,0,-3,-12,58,70,0,-3.79050291191457
2002,6681,10803,0,5,13,78,65,1,7.08775117177585
2003,3836,91,0,3,5,67,62,1,-1.02799405159857
2003,3286,306,0,-8,-1,95,96,0,-11.7002465643581
2003,4167,306,0,-1,3,78,75,1,0.999426725731041
2003,6560,306,0,-4,-17,71,88,0,-6.05886076750926
2003,10004,306,0,-15,-29,51,80,0,-24.7152204333967
2003,4167,340,0,8,32,108,76,1,8.94153883525838
2003,5095,340,0,3,-13,71,84,0,-1.66095467349314
2003,8457,531,0,3,-2,63,65,0,2.53558230804529
2003,8680,531,0,7,1,79,78,1,5.2615589714981
2003,10350,531,0,8,-6,62,68,0,5.39925302766847
2003,4614,572,0,9,22,86,64,1,21.2604522084706
2003,4614,1031,0,8,-8,71,79,0,12.6130030484217
2003,5366,1031,0,7,-1,46,47,0,10.2306139083202
2003,6682,1031,0,11,11,65,54,1,11.7157813518743
2003,1797,1065,0,7,5,58,53,1,1.43352992609144
2003,1898,1099,0,5,-6,73,79,0,8.96316304324476
2003,2358,1099,0,8,26,86,60,1,12.5029495715519
2003,5947,1157,0,-1,-2,74,76,0,-0.156570988330001
2003,6682,1157,0,7,9,74,65,1,7.84488693388477
2003,3286,1466,0,-1,5,74,69,1,-1.61598349213815
2003,5264,1695,0,3,15,79,64,1,1.68851449810175
2003,2358,1729,0,11,10,67,57,1,13.9538060383094
2003,1065,1797,0,-7,-5,53,58,0,-1.43352992608949
2003,8593,1797,0,1,-11,74,85,0,-1.643312866282
2003,8900,1797,0,4,4,82,78,1,4.04750556221218
2003,1099,1898,0,-5,6,79,73,1,-8.96316304324149
2003,9185,2100,0,-9,13,84,71,1,-1.90263184702484
2003,1099,2358,0,-8,-26,60,86,0,-12.5029495715498
2003,1729,2358,0,-11,-10,57,67,0,-13.9538060383079
2003,4167,2358,0,1,4,69,65,1,5.08292157006012
2003,10350,2625,0,13,3,76,73,1,19.3420051043917
2003,5264,2797,0,-5,22,68,46,1,-4.2293515759045
2003,7609,2797,0,-13,-30,55,85,0,-20.2183469024251
2003,306,3286,0,8,1,96,95,1,11.7002465643631
2003,1466,3286,0,1,-5,69,74,0,1.61598349214123
2003,4891,3543,0,11,4,72,68,1,11.5442447382442
2003,6560,3763,0,-1,8,68,60,1,-2.95063102521163
2003,10242,3763,0,-9,-5,60,65,0,-13.0257983453011
2003,91,3836,0,-3,-5,62,67,0,1.02799405159784
2003,7018,3836,0,5,22,74,52,1,8.27443159519197
2003,4282,4008,0,15,31,95,64,1,24.7904294557214
2003,306,4167,0,1,-3,75,78,0,-0.999426725721076
2003,340,4167,0,-8,-32,76,108,0,-8.94153883525156
2003,2358,4167,0,-1,-4,65,69,0,-5.08292157005303
2003,4891,4167,0,-1,-33,61,94,0,-8.02617631963257
2003,8680,4167,0,-1,3,81,78,1,-6.94451448978565
2003,9817,4167,0,-13,-3,61,64,0,-20.9228139541202
2003,4008,4282,0,-15,-31,64,95,0,-24.790429455721
2003,4891,4282,0,-2,14,83,69,1,-6.35569202439856
2003,9783,4282,0,-8,-20,54,74,0,-11.4888218745213
2003,10682,4282,0,-4,-6,57,63,0,-4.85409012033992
2003,572,4614,0,-9,-22,64,86,0,-21.2604522084717
2003,1031,4614,0,-8,8,79,71,1,-12.6130030484199
2003,7219,4750,0,-1,24,80,56,1,-1.75142733844995
2003,8680,4823,0,11,11,76,65,1,12.2356535490347
2003,3543,4891,0,-11,-4,68,72,0,-11.5442447382421
2003,4167,4891,0,1,33,94,61,1,8.02617631964024
2003,4282,4891,0,2,-14,69,83,0,6.35569202440031
2003,5400,4891,0,-3,-9,92,101,0,-1.0690596236117
2003,7018,4891,0,1,-3,74,77,0,4.64861525595
2003,5264,4959,0,-1,2,60,58,1,-5.80669816808557
2003,9613,4959,0,-5,-2,73,75,0,-12.7242193014476
2003,10804,4959,0,3,-13,64,77,0,-4.26568088269355
2003,340,5095,0,-3,13,84,71,1,1.66095467349567
2003,1695,5264,0,-3,-15,64,79,0,-1.68851449810193
2003,2797,5264,0,5,-22,46,68,0,4.2293515759057
2003,4959,5264,0,1,-2,58,60,0,5.80669816808659
2003,8900,5264,0,6,9,85,76,1,4.41498632089725
2003,1031,5366,0,-7,1,47,46,1,-10.2306139083167
2003,4891,5400,0,3,9,101,92,1,1.06905962361365
2003,7558,5400,0,-5,-1,71,72,0,-6.89235021998184
2003,1157,5947,0,1,2,76,74,1,0.156570988328305
2003,306,6560,0,4,17,88,71,1,6.05886076751165
2003,3763,6560,0,1,-8,60,68,0,2.95063102520694
2003,10548,6560,0,-7,-1,69,70,0,-10.1423282998766
2003,1031,6682,0,-11,-11,54,65,0,-11.7157813518713
2003,1157,6682,0,-7,-9,65,74,0,-7.84488693388389
2003,7511,6682,0,-15,-17,54,71,0,-29.3194759353267
2003,8680,6682,0,-2,16,63,47,1,-2.21338801178687
2003,6916,6716,0,-5,-14,63,77,0,-6.00659828767579
2003,8680,6716,0,3,12,68,56,1,2.76030341882071
2003,9783,6814,0,-1,2,60,58,1,-3.03081518502294
2003,6716,6916,0,5,14,77,63,1,6.00659828767506
2003,3836,7018,0,-5,-22,52,74,0,-8.27443159519145
2003,4891,7018,0,-1,3,77,74,1,-4.64861525594627
2003,10316,7018,0,-13,-26,61,87,0,-24.490407981152
2003,4750,7219,0,1,-24,56,80,0,1.75142733844841
2003,8900,7219,0,8,10,77,67,1,4.02617100767426
2003,6682,7511,0,15,17,71,54,1,29.3194759353271
2003,5400,7558,0,5,1,72,71,1,6.89235021998165
2003,2797,7609,0,13,30,85,55,1,20.2183469024268
2003,8593,7677,0,9,8,77,69,1,8.25493485851325
2003,531,8457,0,-3,2,65,63,1,-2.53558230804624
2003,1797,8593,0,-1,11,85,74,1,1.64331286628546
2003,7677,8593,0,-9,-8,69,77,0,-8.25493485851256
2003,531,8680,0,-7,-1,78,79,0,-5.26155897150023
2003,4167,8680,0,1,-3,78,81,0,6.94451448979101
2003,4823,8680,0,-11,-11,65,76,0,-12.2356535490346
2003,6682,8680,0,2,-16,47,63,0,2.21338801178825
2003,6716,8680,0,-3,-12,56,68,0,-2.76030341882175
2003,8900,8680,0,2,-11,84,95,0,1.83911856821915
2003,1797,8900,0,-4,-4,78,82,0,-4.04750556220923
2003,5264,8900,0,-6,-9,76,85,0,-4.41498632089837
2003,7219,8900,0,-8,-10,67,77,0,-4.02617100767563
2003,8680,8900,0,-2,11,95,84,1,-1.83911856821999
2003,9552,8900,0,-15,-21,61,82,0,-33.2744323004076
2003,10804,9121,0,11,12,71,59,1,13.7782629411056
2003,2100,9185,0,9,-13,71,84,0,1.90263184702721
2003,10682,9185,0,8,1,61,60,1,8.29742798699073
2003,9552,9253,0,0,8,92,84,1,-5.0016047167285
2003,8900,9552,0,15,21,82,61,1,33.2744323004074
2003,9253,9552,0,0,-8,84,92,0,5.00160471672885
2003,4959,9613,0,5,2,75,73,1,12.724219301449
2003,4282,9783,0,8,20,74,54,1,11.4888218745217
2003,6814,9783,0,1,-2,58,60,0,3.03081518502504
2003,4167,9817,0,13,3,64,61,1,20.9228139541256
2003,306,10004,0,15,29,80,51,1,24.715220433401
2003,3763,10242,0,9,5,65,60,1,13.0257983452982
2003,7018,10316,0,13,26,87,61,1,24.4904079811538
2003,531,10350,0,-8,6,68,62,1,-5.39925302767067
2003,2625,10350,0,-13,-3,73,76,0,-19.3420051043909
2003,10682,10452,0,7,7,81,74,1,13.5418120103231
2003,6560,10548,0,7,1,70,69,1,10.1423282998747
2003,4282,10682,0,4,6,63,57,1,4.85409012033923
2003,9185,10682,0,-8,-1,60,61,0,-8.29742798699095
2003,10452,10682,0,-7,-7,74,81,0,-13.5418120103238
2003,4959,10804,0,-3,13,77,64,1,4.26568088269564
2003,9121,10804,0,-11,-12,59,71,0,-13.778262941105
2004,6300,24,0,5,11,63,52,1,10.4551090975827
2004,1798,92,0,6,16,87,71,1,7.16105218187525
2004,7559,92,0,-1,-1,64,65,0,-4.02711870242974
2004,8594,92,0,7,-3,67,70,0,3.26040093249832
2004,8681,92,0,3,-9,71,80,0,-1.90327782456514
2004,2359,145,0,15,35,96,61,1,37.0312904071322
2004,7978,307,0,1,4,80,76,1,-1.19289183030095
2004,3253,783,0,3,3,57,54,1,9.86375254892082
2004,9784,783,0,-5,-7,51,58,0,0.251580009017865
2004,8681,1066,0,7,5,80,75,1,-0.461294443853756
2004,9003,1365,0,1,3,76,73,1,2.0424856255903
2004,2626,1467,0,-9,-3,77,80,0,-16.4118213532843
2004,3764,1467,0,-1,24,92,68,1,-4.66588064717849
2004,92,1798,0,-6,-16,71,87,0,-7.16105218187752
2004,2223,1798,0,-5,-17,55,72,0,-12.4332180811137
2004,2359,1798,0,1,-1,78,79,0,4.15415651096782
2004,3253,1798,0,-1,-9,73,82,0,-0.31054214872964
2004,9971,1798,0,-4,-20,53,73,0,-5.58951301082039
2004,10005,1798,0,-13,-17,53,70,0,-24.7215180546972
2004,2223,2101,0,3,7,76,69,1,2.16741329863449
2004,1798,2223,0,5,17,72,55,1,12.4332180811102
2004,2101,2223,0,-3,-7,69,76,0,-2.16741329863498
2004,145,2359,0,-15,-35,61,96,0,-37.0312904071304
2004,1798,2359,0,-1,1,79,78,1,-4.15415651096292
2004,3764,2359,0,-4,-10,62,72,0,-10.3159383425757
2004,7978,2359,0,-7,-28,62,90,0,-11.3919310450444
2004,10805,2359,0,-6,-3,63,66,0,-13.7077244785572
2004,6717,2529,0,13,19,75,56,1,19.2707367068916
2004,1467,2626,0,9,3,80,77,1,16.4118213532872
2004,4824,2798,0,-7,15,75,60,1,-9.42172409448722
2004,4283,2832,0,15,20,96,76,1,30.6494729058891
2004,4419,2832,0,0,-15,57,72,0,4.16129509697083
2004,783,3253,0,-3,-3,54,57,0,-9.86375254892171
2004,1798,3253,0,1,9,82,73,1,0.310542148728533
2004,4168,3253,0,-1,-8,71,79,0,-5.66495111066168
2004,6031,3253,0,-7,-5,67,72,0,-7.39390033951406
2004,6459,3253,0,-11,-5,60,65,0,-14.975391802321
2004,6717,3253,0,1,-2,65,67,0,-1.22099117168643
2004,6031,3287,0,-8,19,91,72,1,-5.61872287341534
2004,9937,3287,0,-13,-27,49,76,0,-19.3956367041873
2004,4168,3730,0,9,25,78,53,1,9.48050436121693
2004,1467,3764,0,1,-24,68,92,0,4.66588064717977
2004,2359,3764,0,4,10,72,62,1,10.3159383425813
2004,5768,3764,0,-7,-19,53,72,0,-7.88470727884539
2004,3253,4168,0,1,8,79,71,1,5.66495111066184
2004,3730,4168,0,-9,-25,53,78,0,-9.48050436121619
2004,6883,4168,0,-8,-15,63,78,0,-10.3504925165928
2004,9288,4168,0,-5,-26,74,100,0,-3.27215467974393
2004,2832,4283,0,-15,-20,76,96,0,-30.6494729058859
2004,9288,4283,0,-8,1,76,75,1,-7.41265592796775
2004,2832,4419,0,0,15,72,57,1,-4.16129509696873
2004,8458,4449,0,15,19,82,63,1,23.1666854594985
2004,10805,4615,0,3,10,80,70,1,-7.3265362296673
2004,2798,4824,0,7,-15,60,75,0,9.42172409448707
2004,10351,4824,0,8,4,84,80,1,11.3787706662935
2004,8681,4960,0,-1,2,72,70,1,-4.94192780732678
2004,9866,4960,0,-9,-3,83,86,0,-6.32381478024391
2004,6717,5096,0,5,17,70,53,1,7.11820070902705
2004,8146,5096,0,-3,-16,43,59,0,0.623496245202386
2004,6031,5265,0,-3,6,72,66,1,2.06793785747121
2004,5498,5367,0,-13,-33,52,85,0,-21.9011050501524
2004,10805,5367,0,-5,15,89,74,1,-5.22667250860175
2004,5367,5498,0,13,33,85,52,1,21.9011050501516
2004,3764,5768,0,7,19,72,53,1,7.88470727884609
2004,9455,5948,0,-11,-9,52,61,0,-12.7118547624198
2004,9971,5948,0,-3,2,75,73,1,-2.82591504479298
2004,3253,6031,0,7,5,72,67,1,7.39390033951438
2004,3287,6031,0,8,-19,72,91,0,5.61872287341402
2004,5265,6031,0,3,-6,66,72,0,-2.06793785747119
2004,24,6300,0,-5,-11,52,63,0,-10.4551090975891
2004,8901,6300,0,3,3,78,75,1,-1.12767123361885
2004,3253,6459,0,11,5,65,60,1,14.975391802321
2004,2529,6717,0,-13,-19,56,75,0,-19.2707367068922
2004,3253,6717,0,-1,2,67,65,1,1.22099117168654
2004,5096,6717,0,-5,-17,53,70,0,-7.11820070902691
2004,7019,6717,0,-1,-12,51,63,0,-1.81336091153858
2004,8458,6717,0,1,-2,62,64,0,-0.239453819218584
2004,4168,6883,0,8,15,78,63,1,10.3504925165921
2004,7186,6883,0,7,-8,58,66,0,9.82493805573508
2004,6717,7019,0,1,12,63,51,1,1.81336091153873
2004,9387,7019,0,-11,-9,44,53,0,-16.5415024725062
2004,10683,7019,0,-3,-4,55,59,0,0.232003007704325
2004,8901,7152,0,11,17,66,49,1,17.1475267319013
2004,6883,7186,0,-7,8,66,58,1,-9.82493805573699
2004,10683,7376,0,5,12,76,64,1,8.60135757891681
2004,92,7559,0,1,1,65,64,1,4.02711870242661
2004,307,7978,0,-1,-4,76,80,0,1.19289183030226
2004,2359,7978,0,7,28,90,62,1,11.3919310450499
2004,5096,8146,0,3,16,59,43,1,-0.623496245201558
2004,4449,8458,0,-15,-19,63,82,0,-23.1666854594998
2004,6717,8458,0,-1,2,64,62,1,0.239453819218364
2004,9003,8458,0,-7,-5,65,70,0,-5.40615960601817
2004,10351,8458,0,-3,-4,80,84,0,-0.513393577240484
2004,92,8594,0,-7,3,70,67,1,-3.26040093250064
2004,9750,8594,0,-15,-26,45,71,0,-24.9255699611832
2004,92,8681,0,-3,9,80,71,1,1.90327782456358
2004,1066,8681,0,-7,-5,75,80,0,0.461294443852244
2004,4960,8681,0,1,-2,70,72,0,4.94192780732523
2004,6300,8901,0,-3,-3,75,78,0,1.12767123361974
2004,7152,8901,0,-11,-17,49,66,0,-17.1475267319001
2004,10805,8901,0,-4,8,79,71,1,-6.50738589502923
2004,1365,9003,0,-1,-3,73,76,0,-2.04248562559012
2004,8458,9003,0,7,5,70,65,1,5.4061596060175
2004,4168,9288,0,5,26,100,74,1,3.27215467974425
2004,4283,9288,0,8,-1,75,76,0,7.41265592796786
2004,10385,9288,0,1,-2,100,102,0,-2.78540079048468
2004,7019,9387,0,11,9,53,44,1,16.5415024725066
2004,5948,9455,0,11,9,61,52,1,12.7118547624202
2004,8594,9750,0,15,26,71,45,1,24.9255699611826
2004,783,9784,0,5,7,58,51,1,-0.251580009018712
2004,4960,9866,0,9,3,86,83,1,6.32381478024271
2004,10351,9903,0,9,1,79,78,1,12.9361634430361
2004,3287,9937,0,13,27,76,49,1,19.3956367041855
2004,1798,9971,0,4,20,73,53,1,5.58951301081987
2004,5948,9971,0,3,-2,73,75,0,2.82591504479453
2004,10277,9971,0,-5,-13,58,71,0,-3.31529161028479
2004,1798,10005,0,13,17,70,53,1,24.7215180546967
2004,9971,10277,0,5,13,71,58,1,3.31529161028549
2004,4824,10351,0,-8,-4,80,84,0,-11.3787706662938
2004,8458,10351,0,3,4,84,80,1,0.513393577240342
2004,9903,10351,0,-9,-1,78,79,0,-12.9361634430356
2004,9288,10385,0,-1,2,102,100,1,2.78540079048474
2004,7019,10683,0,3,4,59,55,1,-0.232003007704622
2004,7376,10683,0,-5,-12,64,76,0,-8.60135757891725
2004,2359,10805,0,6,3,66,63,1,13.7077244785653
2004,4615,10805,0,-3,-10,70,80,0,7.32653622967213
2004,5367,10805,0,5,-15,74,89,0,5.22667250860053
2004,8901,10805,0,4,-8,71,79,0,6.50738589503165
2005,10550,93,0,-7,10,83,73,1,-8.38650195245029
2005,6581,112,0,0,10,79,69,1,9.31971741591323
2005,3765,308,0,2,1,90,89,1,6.59014070154836
2005,6718,308,0,1,-1,78,79,0,4.98513762831472
2005,9289,308,0,-8,-22,63,85,0,-6.81896614675782
2005,9819,308,0,-11,-13,53,66,0,-4.20082283228727
2005,6918,784,0,-9,-20,65,85,0,-9.38594562372804
2005,10550,784,0,-8,8,83,75,1,-5.46484507877264
2005,4169,972,0,11,-1,63,64,0,20.3285556887155
2005,10684,972,0,8,9,71,62,1,15.3971580010104
2005,5949,1366,0,-3,12,75,63,1,6.72734075162441
2005,10352,1400,0,13,16,70,54,1,22.8051704639114
2005,3940,1468,0,-3,-12,64,76,0,-1.77587616644226
2005,4284,1468,0,5,9,69,60,1,2.54050648840293
2005,5949,1799,0,-8,3,65,62,1,-3.39134871765673
2005,9388,1799,0,-13,-6,71,77,0,-25.4376451467043
2005,10488,1900,0,3,2,63,61,1,1.06407325302518
2005,2360,2170,0,15,11,57,46,1,31.7422089480323
2005,2170,2360,0,-15,-11,46,57,0,-31.7422089480292
2005,5266,2360,0,-4,10,78,68,1,-3.85387270649159
2005,5368,2360,0,-8,-8,55,63,0,-12.3504228916672
2005,4284,2462,0,13,8,72,64,1,22.7996834097638
2005,3765,2695,0,15,12,67,55,1,28.2478276340606
2005,6615,2799,0,-9,-5,62,67,0,-16.0624158847869
2005,10040,2799,0,-1,11,76,65,1,-2.63003978153782
2005,3254,3034,0,7,12,80,68,1,7.16879232391479
2005,3034,3254,0,-7,-12,68,80,0,-7.16879232391383
2005,4616,3254,0,1,22,76,54,1,4.50817668069663
2005,9004,3288,0,-3,2,71,69,1,2.85445641115345
2005,10650,3288,0,-11,-10,64,74,0,-13.0481872358439
2005,308,3765,0,-2,-1,89,90,0,-6.59014070155141
2005,2695,3765,0,-15,-12,55,67,0,-28.2478276340583
2005,4616,3765,0,-3,-15,57,72,0,-1.37242272594105
2005,6032,3765,0,-8,-12,59,71,0,-15.541866472487
2005,6301,3765,0,0,5,75,70,1,4.90262626907503
2005,10550,3765,0,-11,-14,63,77,0,-14.8417457793021
2005,1468,3940,0,3,12,76,64,1,1.77587616644418
2005,5300,3974,0,1,-11,53,64,0,1.24293623362682
2005,6301,3974,0,8,27,92,65,1,17.417438148006
2005,972,4169,0,-11,1,64,63,1,-20.3285556887178
2005,1468,4284,0,-5,-9,60,69,0,-2.54050648840048
2005,2462,4284,0,-13,-8,64,72,0,-22.7996834097628
2005,5266,4284,0,-3,6,94,88,1,0.960768640863153
2005,9785,4284,0,-4,-10,52,62,0,-6.60088909316968
2005,3254,4616,0,-1,-22,54,76,0,-4.50817668069435
2005,3765,4616,0,3,15,72,57,1,1.37242272594549
2005,9456,4616,0,-9,-6,62,68,0,-17.1383937810231
2005,10386,4616,0,3,-14,79,93,0,-1.96087812234851
2005,10488,4616,0,-3,-8,85,93,0,-11.4651161134788
2005,9289,4752,0,-5,14,82,68,1,-1.73364695866098
2005,2360,5266,0,4,-10,68,78,0,3.85387270649583
2005,4284,5266,0,3,-6,88,94,0,-0.960768640859731
2005,6301,5266,0,4,16,87,71,1,8.194514450578
2005,6752,5266,0,-7,-8,81,89,0,-14.4754798853408
2005,10006,5266,0,-8,-11,61,72,0,-12.9619171498275
2005,3974,5300,0,-1,11,64,53,1,-1.24293623362836
2005,2360,5368,0,8,8,63,55,1,12.3504228916688
2005,8595,5368,0,1,-23,70,93,0,-2.37526169851883
2005,10386,5533,0,15,11,88,77,1,24.5275951987465
2005,1366,5949,0,3,-12,63,75,0,-6.72734075162541
2005,1799,5949,0,8,-3,62,65,0,3.39134871765649
2005,10684,5949,0,4,9,65,56,1,0.161912284566139
2005,3765,6032,0,8,12,71,59,1,15.5418664724885
2005,8902,6032,0,1,-4,57,61,0,7.83883303285275
2005,10040,6100,0,7,8,55,47,1,7.2521931506566
2005,6684,6200,0,11,17,84,67,1,17.7677192064845
2005,3765,6301,0,0,-5,70,75,0,-4.90262626907357
2005,3974,6301,0,-8,-27,65,92,0,-17.4174381480077
2005,5266,6301,0,-4,-16,71,87,0,-8.19451445057545
2005,6581,6301,0,-15,-28,68,96,0,-31.3618805982588
2005,10040,6301,0,-4,-1,66,67,0,-10.3738837225584
2005,10684,6301,0,-5,-6,82,88,0,-12.1842139766828
2005,10684,6460,0,5,5,57,52,1,7.13573999293094
2005,112,6581,0,0,-10,69,79,0,-9.31971741592277
2005,6301,6581,0,15,28,96,68,1,31.3618805982596
2005,2799,6615,0,9,5,67,62,1,16.0624158847868
2005,6200,6684,0,-11,-17,67,84,0,-17.7677192064853
2005,9785,6684,0,-3,9,67,58,1,-7.88763984072519
2005,308,6718,0,-1,1,79,78,1,-4.98513762831743
2005,7560,6718,0,-5,-8,77,85,0,-11.1585975417713
2005,7908,6718,0,-13,-13,50,63,0,-23.5177329419498
2005,5266,6752,0,7,8,89,81,1,14.4754798853427
2005,7020,6884,0,-1,-8,71,79,0,6.63098901135971
2005,10386,6884,0,7,18,97,79,1,12.150809680791
2005,784,6918,0,9,20,85,65,1,9.38594562372353
2005,6884,7020,0,1,8,79,71,1,-6.63098901135949
2005,6718,7560,0,5,8,85,77,1,11.1585975417726
2005,8527,7560,0,-3,-9,56,65,0,-4.13613993849981
2005,6718,7908,0,13,13,63,50,1,23.5177329419505
2005,7560,8527,0,3,9,65,56,1,4.13613993849917
2005,5368,8595,0,-1,23,93,70,1,2.37526169851903
2005,10006,8682,0,-9,3,60,57,1,-9.39877401575421
2005,6032,8902,0,-1,4,61,57,1,-7.83883303285289
2005,3288,9004,0,3,-2,69,71,0,-2.85445641115164
2005,9422,9004,0,-5,-12,66,78,0,-6.94047368246351
2005,10488,9004,0,-1,5,65,60,1,-5.48043026301095
2005,308,9289,0,8,22,85,63,1,6.81896614675377
2005,4752,9289,0,5,-14,68,82,0,1.73364695866142
2005,1799,9388,0,13,6,77,71,1,25.4376451467033
2005,9004,9422,0,5,12,78,66,1,6.94047368246411
2005,4616,9456,0,9,6,68,62,1,17.1383937810269
2005,4284,9785,0,4,10,62,52,1,6.60088909317074
2005,6684,9785,0,3,-9,58,67,0,7.88763984072551
2005,9867,9785,0,-5,-6,54,60,0,-3.58016393853221
2005,308,9819,0,11,13,66,53,1,4.20082283228322
2005,9785,9867,0,5,6,60,54,1,3.58016393853179
2005,5266,10006,0,8,11,72,61,1,12.9619171498292
2005,8682,10006,0,9,-3,57,60,0,9.39877401575319
2005,2799,10040,0,1,-11,65,76,0,2.63003978153859
2005,6100,10040,0,-7,-8,47,55,0,-7.2521931506568
2005,6301,10040,0,4,1,67,66,1,10.3738837225587
2005,1400,10352,0,-13,-16,54,70,0,-22.8051704639122
2005,10488,10352,0,-5,6,111,105,1,-10.1101355139626
2005,4616,10386,0,-3,14,93,79,1,1.96087812235219
2005,5533,10386,0,-15,-11,77,88,0,-24.5275951987466
2005,6884,10386,0,-7,-18,79,97,0,-12.150809680791
2005,1900,10488,0,-3,-2,61,63,0,-1.06407325302584
2005,4616,10488,0,3,8,93,85,1,11.4651161134822
2005,9004,10488,0,1,-5,60,65,0,5.48043026301172
2005,10352,10488,0,5,-6,105,111,0,10.1101355139621
2005,93,10550,0,7,-10,73,83,0,8.38650195244963
2005,784,10550,0,8,-8,75,83,0,5.46484507876816
2005,3765,10550,0,11,14,77,63,1,14.841745779303
2005,3288,10650,0,11,10,74,64,1,13.0481872358446
2005,972,10684,0,-8,-9,62,71,0,-15.3971580010119
2005,5949,10684,0,-4,-9,56,65,0,-0.161912284565403
2005,6301,10684,0,5,6,88,82,1,12.1842139766834
2005,6460,10684,0,-5,-5,52,57,0,-7.13573999292965
2006,3766,26,0,9,9,78,69,1,6.73324052149823
2006,4894,94,0,3,-5,85,90,0,1.64017471685168
2006,9423,94,0,8,3,62,59,1,6.31784385290855
2006,1800,166,0,15,13,72,59,1,22.5954289381054
2006,10041,309,0,7,4,82,78,1,5.54833633433228
2006,10685,309,0,-1,-19,75,94,0,-0.930135169688949
2006,973,431,0,-1,4,59,55,1,-7.8360270601657
2006,9423,662,0,13,34,78,44,1,18.757966968225
2006,5534,785,0,-8,-13,56,69,0,-8.93559464876456
2006,6885,785,0,-9,-12,76,88,0,-6.11070343405727
2006,10041,785,0,3,1,60,59,1,6.01377885365205
2006,4170,887,0,9,-4,73,77,0,9.05769073858572
2006,5098,887,0,12,16,80,64,1,7.03441263468863
2006,7021,887,0,8,-6,66,72,0,5.15576425261926
2006,431,973,0,1,-4,55,59,0,7.83602706016532
2006,5098,973,0,8,16,72,56,1,11.1583364176439
2006,5950,1160,0,-3,6,58,52,1,1.31758254964573
2006,166,1800,0,-15,-13,59,72,0,-22.5954289380998
2006,3119,1800,0,-10,2,86,84,1,-11.1223825784261
2006,4285,1800,0,-7,-4,83,87,0,-9.48031932534692
2006,10387,1800,0,-4,-6,92,98,0,-4.23150263906512
2006,6650,2069,0,13,8,70,62,1,15.129238430359
2006,3035,2361,0,-7,-13,61,74,0,-12.3931020117511
2006,4753,2361,0,-3,8,62,54,1,-6.15823731697905
2006,8260,2361,0,-15,-16,54,70,0,-29.355646007548
2006,3119,2800,0,-8,-15,58,73,0,-7.69755864522789
2006,3153,2800,0,-4,-4,53,57,0,-5.18428666333363
2006,8114,2800,0,-11,-26,50,76,0,-13.4375327715524
2006,9423,2800,0,1,-16,57,73,0,-1.95177322904906
2006,10041,2800,0,2,-13,62,75,0,1.35232701005409
2006,10551,2800,0,-8,-22,60,82,0,-10.5423257014174
2006,2361,3035,0,7,13,74,61,1,12.3931020117542
2006,9616,3035,0,-1,-3,85,88,0,-1.63011708160057
2006,1800,3119,0,10,-2,84,86,0,11.1223825784302
2006,2800,3119,0,8,15,73,58,1,7.69755864522819
2006,5267,3119,0,5,-10,65,75,0,2.03828527299402
2006,6302,3119,0,8,-5,60,65,0,8.89884175410462
2006,10585,3119,0,4,-8,55,63,0,-0.0105073169651368
2006,2800,3153,0,4,4,57,53,1,5.18428666333392
2006,6461,3153,0,-3,-5,49,54,0,-1.64298150322794
2006,6650,3153,0,5,-18,52,70,0,4.00045077643106
2006,3839,3289,0,-3,-10,80,90,0,0.620799193100056
2006,9423,3289,0,1,2,73,71,1,4.54147384187832
2006,10807,3289,0,-11,-4,75,79,0,-1.75823753371867
2006,5500,3351,0,0,22,71,49,1,5.75898138843759
2006,26,3766,0,-9,-9,69,78,0,-6.73324052149143
2006,10387,3766,0,-1,3,67,64,1,0.398817929361672
2006,3289,3839,0,3,10,90,80,1,-0.620799193095357
2006,7714,3839,0,-5,-4,83,87,0,-2.47651231816423
2006,4753,3907,0,9,16,80,64,1,9.71265723817706
2006,6529,3941,0,-11,1,64,63,1,-11.6191757457423
2006,887,4170,0,-9,4,77,73,1,-9.05769073858536
2006,7021,4251,0,7,15,79,64,1,10.1479514340141
2006,1800,4285,0,7,4,87,83,1,9.48031932534869
2006,9290,4285,0,-1,-5,64,69,0,-2.93865609475365
2006,2361,4753,0,3,-8,54,62,0,6.15823731698156
2006,3907,4753,0,-9,-16,64,80,0,-9.71265723817602
2006,8903,4753,0,2,-10,60,70,0,5.76305711374797
2006,8937,4753,0,-8,-1,57,58,0,-3.53248761268598
2006,9423,4753,0,2,14,59,45,1,-0.185292602233742
2006,94,4894,0,-3,5,90,85,1,-1.64017471684886
2006,887,5098,0,-12,-16,64,80,0,-7.03441263468836
2006,973,5098,0,-8,-16,56,72,0,-11.1583364176444
2006,6783,5098,0,-15,-16,78,94,0,-15.2530341807967
2006,9423,5098,0,-1,5,50,45,1,-1.85203295838333
2006,3119,5267,0,-5,10,75,65,1,-2.03828527299323
2006,3351,5500,0,0,-22,49,71,0,-5.75898138844414
2006,10041,5500,0,15,13,58,45,1,23.8781309480657
2006,785,5534,0,8,13,69,56,1,8.93559464876829
2006,6033,5534,0,7,-8,79,87,0,6.20734456790281
2006,6302,5770,0,11,4,69,65,1,15.774322075472
2006,1160,5950,0,3,-6,52,58,0,-1.31758254964519
2006,8903,5950,0,8,21,75,54,1,9.1025199753581
2006,5534,6033,0,-7,8,87,79,1,-6.20734456790221
2006,3119,6302,0,-8,5,65,60,1,-8.89884175410483
2006,5770,6302,0,-11,-4,65,69,0,-15.774322075469
2006,3153,6461,0,3,5,54,49,1,1.64298150322847
2006,3941,6529,0,11,-1,63,64,0,11.6191757457404
2006,10489,6529,0,8,13,67,54,1,10.6474054723548
2006,2069,6650,0,-13,-8,62,70,0,-15.1292384303591
2006,3153,6650,0,-5,18,70,52,1,-4.00045077643097
2006,10551,6685,0,-5,8,82,74,1,-4.60767256725006
2006,5098,6783,0,15,16,94,78,1,15.2530341807939
2006,785,6885,0,9,12,88,76,1,6.11070343406119
2006,8903,6919,0,13,8,60,52,1,16.5550605664847
2006,887,7021,0,-8,6,72,66,1,-5.15576425261736
2006,4251,7021,0,-7,-15,64,79,0,-10.147951434014
2006,10489,7561,0,5,18,64,46,1,4.54784885458813
2006,3839,7714,0,5,4,87,83,1,2.47651231816565
2006,10585,7980,0,3,20,86,66,1,3.33749651369171
2006,2800,8114,0,11,26,76,50,1,13.4375327715522
2006,2361,8260,0,15,16,70,54,1,29.3556460075509
2006,8937,8683,0,-7,8,66,58,1,1.28712303177163
2006,10585,8801,0,-5,7,80,73,1,-4.22346366202605
2006,10651,8801,0,-13,-2,61,63,0,-8.78012249435449
2006,4753,8903,0,-2,10,70,60,1,-5.76305711374804
2006,5950,8903,0,-8,-21,54,75,0,-9.10251997535874
2006,6919,8903,0,-13,-8,52,60,0,-16.5550605664866
2006,10489,8903,0,-4,-3,71,74,0,-8.65956174570998
2006,4753,8937,0,8,1,58,57,1,3.53248761268595
2006,8683,8937,0,7,-8,58,66,0,-1.28712303177404
2006,4285,9290,0,1,5,69,64,1,2.93865609475139
2006,94,9423,0,-8,-3,59,62,0,-6.31784385290609
2006,662,9423,0,-13,-34,44,78,0,-18.7579669682278
2006,2800,9423,0,-1,16,73,57,1,1.95177322904885
2006,3289,9423,0,-1,-2,71,73,0,-4.5414738418756
2006,4753,9423,0,-2,-14,45,59,0,0.185292602234334
2006,5098,9423,0,1,-5,45,50,0,1.85203295838125
2006,3035,9616,0,1,3,88,85,1,1.63011708160156
2006,10387,9820,0,7,14,75,61,1,9.47767422374151
2006,309,10041,0,-7,-4,78,82,0,-5.54833633433414
2006,785,10041,0,-3,-1,59,60,0,-6.01377885364921
2006,2800,10041,0,-2,13,75,62,1,-1.35232701005403
2006,5500,10041,0,-15,-13,45,58,0,-23.8781309480673
2006,1800,10387,0,4,6,98,92,1,4.23150263907039
2006,3766,10387,0,1,-3,64,67,0,-0.398817929357715
2006,9820,10387,0,-7,-14,61,75,0,-9.47767422374035
2006,6529,10489,0,-8,-13,54,67,0,-10.6474054723553
2006,7561,10489,0,-5,-18,46,64,0,-4.54784885458787
2006,8903,10489,0,4,3,74,71,1,8.65956174570986
2006,2800,10551,0,8,22,82,60,1,10.5423257014172
2006,6685,10551,0,5,-8,74,82,0,4.60767256724923
2006,3119,10585,0,-4,8,63,55,1,0.0105073169652669
2006,7980,10585,0,-3,-20,66,86,0,-3.33749651369181
2006,8801,10585,0,5,-7,73,80,0,4.22346366202597
2006,8801,10651,0,13,2,63,61,1,8.7801224943544
2006,309,10685,0,1,19,94,75,1,0.930135169686232
2006,3289,10807,0,11,4,79,75,1,1.7582375337222
2007,10076,167,0,9,27,84,57,1,14.3941854170702
2007,7223,310,0,-1,9,72,63,1,-1.90134696907292
2007,9685,432,0,7,17,77,60,1,-1.54477306844172
2007,3154,663,0,13,25,80,55,1,18.0664997565595
2007,3154,786,0,5,7,62,55,1,5.45161642950286
2007,9006,786,0,-3,-9,75,84,0,-3.91949785093442
2007,2801,1035,0,4,8,65,57,1,9.72486575347415
2007,4963,1035,0,1,-3,59,62,0,5.83131943677494
2007,6754,1035,0,-7,-11,46,57,0,-5.65938172586293
2007,10808,1069,0,-1,2,79,77,1,3.14019875640423
2007,6651,1300,0,15,21,78,57,1,25.270178891484
2007,6034,1902,0,3,6,77,71,1,-2.26203013071578
2007,4963,2070,0,9,12,82,70,1,10.5190925924581
2007,9906,2362,0,-5,2,79,77,1,-10.7901194944097
2007,6303,2464,0,15,21,86,65,1,31.8821087458948
2007,1035,2801,0,-4,-8,57,65,0,-9.7248657534701
2007,4046,2801,0,-15,-43,69,112,0,-35.3444203694932
2007,6651,2801,0,0,-9,75,84,0,-1.65214982350366
2007,6818,2801,0,-2,-8,77,85,0,-7.45347988381266
2007,7223,2801,0,-8,-7,67,74,0,-8.8060473969119
2007,9424,2801,0,-1,-10,66,76,0,-3.06476765404551
2007,6202,2835,0,0,8,77,69,1,6.79018855763207
2007,9974,3036,0,5,33,77,44,1,5.10550581849857
2007,663,3154,0,-13,-25,55,80,0,-18.0664997565659
2007,786,3154,0,-5,-7,55,62,0,-5.45161642950342
2007,6303,3154,0,1,-12,84,96,0,7.98588796338845
2007,6651,3154,0,1,7,67,60,1,2.25518327325296
2007,9974,3154,0,-4,-1,65,66,0,-7.9386151765235
2007,9651,3256,0,3,4,67,63,1,-5.81231496174059
2007,3840,3290,0,3,13,70,57,1,4.18467686710068
2007,7562,3547,0,9,10,61,51,1,9.72719267604178
2007,10110,3767,0,7,2,54,52,1,0.592408756353055
2007,3290,3840,0,-3,-13,57,70,0,-4.18467686709789
2007,9424,3840,0,5,5,54,49,1,3.4736971246721
2007,2801,4046,0,15,43,112,69,1,35.3444203694935
2007,4286,4171,0,-7,-12,76,88,0,-6.26096217820312
2007,6202,4171,0,-15,-40,67,107,0,-26.2832180100649
2007,7562,4171,0,-3,-3,58,61,0,-10.1074930806436
2007,9424,4171,0,-1,13,68,55,1,-2.9330372705518
2007,4171,4286,0,7,12,88,76,1,6.26096217819811
2007,10042,4286,0,-1,-9,58,67,0,-0.393818812468382
2007,8802,4502,0,7,35,121,86,1,11.1480630149035
2007,8597,4618,0,-5,-20,58,78,0,-4.77398120751117
2007,8938,4618,0,3,3,72,69,1,6.17576990764032
2007,5268,4895,0,-1,12,61,49,1,2.20039387820624
2007,1035,4963,0,-1,3,62,59,1,-5.83131943676935
2007,2070,4963,0,-9,-12,70,82,0,-10.5190925924584
2007,6034,5099,0,-5,-16,62,78,0,-9.47663357999697
2007,6360,5099,0,-13,-15,58,73,0,-23.4048794625315
2007,6651,5099,0,1,16,92,76,1,1.56612657508041
2007,8938,5099,0,-1,-1,64,65,0,1.74759185117908
2007,6818,5200,0,11,2,58,56,1,11.1038365956572
2007,4895,5268,0,1,-12,49,61,0,-2.20039387820321
2007,6303,5268,0,8,14,81,67,1,10.9917181373557
2007,1902,6034,0,-3,-6,71,77,0,2.26203013071282
2007,5099,6034,0,5,16,78,62,1,9.47663357999919
2007,8904,6136,0,9,12,79,67,1,11.3951320886782
2007,2835,6202,0,0,-8,69,77,0,-6.79018855763241
2007,4171,6202,0,15,40,107,67,1,26.2832180100599
2007,2464,6303,0,-15,-21,65,86,0,-31.8821087458884
2007,3154,6303,0,-1,12,96,84,1,-7.98588796338803
2007,5268,6303,0,-8,-14,67,81,0,-10.991718137352
2007,9685,6303,0,-4,-10,64,74,0,-14.8532116715796
2007,5099,6360,0,13,15,73,58,1,23.4048794625347
2007,10652,6564,0,-5,10,74,64,1,-9.13100211020011
2007,1300,6651,0,-15,-21,57,78,0,-25.2701788914816
2007,2801,6651,0,0,9,84,75,1,1.65214982350308
2007,3154,6651,0,-1,-7,60,67,0,-2.25518327325441
2007,5099,6651,0,-1,-16,76,92,0,-1.56612657507838
2007,8802,6651,0,-4,-1,84,85,0,-7.63142383664127
2007,10808,6651,0,-8,-7,71,78,0,-7.28567186890567
2007,1035,6754,0,7,11,57,46,1,5.65938172586628
2007,10422,6784,0,11,16,70,54,1,8.00511167128136
2007,2801,6818,0,2,8,85,77,1,7.45347988381225
2007,5200,6818,0,-11,-2,56,58,0,-11.1038365956552
2007,9651,6818,0,-4,-4,72,76,0,-3.64486814112343
2007,10652,6818,0,-8,-14,61,75,0,-7.17855923696723
2007,8938,6920,0,11,16,68,52,1,17.6387835491845
2007,9424,7022,0,1,9,64,55,1,3.14159881485223
2007,9906,7022,0,-8,-5,79,84,0,-8.35625932993623
2007,10740,7022,0,-11,-21,58,79,0,-14.9382703194305
2007,310,7223,0,1,-9,63,72,0,1.90134696907533
2007,2801,7223,0,8,7,74,67,1,8.80604739691163
2007,3547,7562,0,-9,-10,51,61,0,-9.72719267603656
2007,4171,7562,0,3,3,61,58,1,10.1074930806399
2007,10110,7562,0,-1,-15,48,63,0,2.08662455356229
2007,4618,8597,0,5,20,78,58,1,4.77398120751196
2007,10686,8700,0,13,13,76,63,1,16.9631303591693
2007,4502,8802,0,-7,-35,86,121,0,-11.1480630149059
2007,6651,8802,0,4,1,85,84,1,7.63142383663991
2007,10076,8802,0,1,-3,74,77,0,-0.919559224125698
2007,6136,8904,0,-9,-12,67,79,0,-11.395132088679
2007,9685,8904,0,-1,19,87,68,1,-4.0206297463633
2007,4618,8938,0,-3,-3,69,72,0,-6.17576990763925
2007,5099,8938,0,1,1,65,64,1,-1.7475918511766
2007,6920,8938,0,-11,-16,52,68,0,-17.638783549187
2007,786,9006,0,3,9,84,75,1,3.91949785093382
2007,2801,9424,0,1,10,76,66,1,3.06476765404528
2007,3840,9424,0,-5,-5,49,54,0,-3.47369712467237
2007,4171,9424,0,1,-13,55,68,0,2.93303727054787
2007,7022,9424,0,-1,-9,55,64,0,-3.14159881485286
2007,10456,9424,0,-13,-28,42,70,0,-23.780421533936
2007,3256,9651,0,-3,-4,63,67,0,5.81231496174247
2007,6818,9651,0,4,4,76,72,1,3.64486814112377
2007,10686,9651,0,5,-6,68,74,0,7.66609729552952
2007,432,9685,0,-7,-17,60,77,0,1.54477306843804
2007,6303,9685,0,4,10,74,64,1,14.8532116715809
2007,8904,9685,0,1,-19,68,87,0,4.02062974636179
2007,2362,9906,0,5,-2,77,79,0,10.7901194944069
2007,7022,9906,0,8,5,84,79,1,8.35625932993573
2007,3036,9974,0,-5,-33,44,77,0,-5.10550581849937
2007,3154,9974,0,4,1,66,65,1,7.93861517652231
2007,10422,9974,0,3,-4,74,78,0,1.62107349646253
2007,4286,10042,0,1,9,67,58,1,0.393818812467255
2007,167,10076,0,-9,-27,57,84,0,-14.3941854170681
2007,8802,10076,0,-1,3,77,74,1,0.919559224123887
2007,3767,10110,0,-7,-2,52,54,0,-0.592408756351619
2007,7562,10110,0,1,15,63,48,1,-2.0866245535611
2007,6784,10422,0,-11,-16,54,70,0,-8.00511167128106
2007,9974,10422,0,-3,4,78,74,1,-1.62107349646324
2007,9424,10456,0,13,28,70,42,1,23.7804215339361
2007,6564,10652,0,5,-10,64,74,0,9.1310021101996
2007,6818,10652,0,8,14,75,61,1,7.17855923696685
2007,8700,10686,0,-13,-13,63,76,0,-16.9631303591697
2007,9651,10686,0,-5,6,74,68,1,-7.66609729552912
2007,7022,10740,0,11,21,79,58,1,14.93827031943
2007,1069,10808,0,1,-2,77,79,0,-3.14019875640437
2007,6651,10808,0,8,7,78,71,1,7.28567186890496
2008,8803,243,0,13,15,72,57,1,21.3806933737
2008,10491,311,0,3,10,75,65,1,2.33883111305209
2008,3841,433,0,1,-14,72,86,0,3.848149712348
2008,6304,433,0,8,31,108,77,1,10.4037062442174
2008,8905,577,0,13,20,74,54,1,21.2539275797719
2008,7224,645,0,5,11,90,79,1,0.842639920833921
2008,2363,664,0,13,1,71,70,1,23.8811566782961
2008,4619,753,0,11,18,79,61,1,15.9379132726646
2008,8116,1036,0,-3,-20,61,81,0,-5.11279520662981
2008,8803,1036,0,5,5,76,71,1,7.06418165913119
2008,8939,1070,0,-1,5,67,62,1,4.41288134396421
2008,10043,1539,0,-7,6,75,69,1,-7.33722290387248
2008,7682,1802,0,-9,1,70,69,1,-13.3802024226892
2008,5704,1835,0,0,9,69,60,1,11.2667006434697
2008,8598,1869,0,11,24,77,53,1,16.0943390415786
2008,10687,1948,0,11,15,71,56,1,14.8273586781234
2008,3155,2071,0,8,-4,70,74,0,6.44683675362156
2008,3291,2071,0,3,-6,76,82,0,2.55009506424429
2008,4172,2071,0,9,2,59,57,1,14.4818462566485
2008,10687,2071,0,7,-17,56,73,0,7.64599846660248
2008,10247,2295,0,-7,2,101,99,1,-5.44001438569815
2008,664,2363,0,-13,-1,70,71,0,-23.8811566782947
2008,10491,2363,0,-5,6,73,67,1,-5.04316160120614
2008,6565,3121,0,7,18,68,50,1,9.62628501025834
2008,2071,3155,0,-8,4,74,70,1,-6.44683675362588
2008,9525,3155,0,-13,-19,47,66,0,-18.8450427038958
2008,10809,3189,0,11,12,73,61,1,10.5462627724353
2008,2071,3291,0,-3,6,82,76,1,-2.55009506424226
2008,433,3841,0,-1,14,86,72,1,-3.84814971234929
2008,2071,4172,0,-9,-2,57,59,0,-14.4818462566542
2008,5100,4172,0,0,-7,68,75,0,-4.04918458827502
2008,6304,4172,0,0,-18,66,84,0,-3.9395721124663
2008,7077,4172,0,-15,-24,61,85,0,-24.8915708257384
2008,9652,4172,0,-7,-19,56,75,0,-16.6767627968427
2008,10043,4172,0,-11,-15,57,72,0,-16.6095596979102
2008,9686,4206,0,5,-13,67,80,0,-1.91692737265416
2008,10687,4206,0,8,17,72,55,1,3.48311109670277
2008,9652,4253,0,1,13,71,58,1,2.24337123330834
2008,4896,4287,0,5,8,74,66,1,9.13322068320862
2008,753,4619,0,-11,-18,61,79,0,-15.9379132726652
2008,6304,4619,0,2,10,83,73,1,5.17177539623981
2008,6687,4619,0,-3,-30,48,78,0,-5.13706983000569
2008,8803,4619,0,1,-19,60,79,0,1.32408522877973
2008,4287,4896,0,-5,-8,66,74,0,-9.13322068320895
2008,8598,4896,0,3,1,82,81,1,-1.30439391151446
2008,4172,5100,0,0,7,75,68,1,4.0491845882636
2008,5269,5100,0,-4,-18,74,92,0,-6.43892753539818
2008,5371,5100,0,-7,-3,74,77,0,-9.98778828269959
2008,8905,5100,0,-1,-18,67,85,0,-4.38350900755276
2008,9425,5100,0,0,-15,63,78,0,-0.54641110906914
2008,9720,5100,0,-15,-24,63,87,0,-25.8286690484747
2008,8530,5167,0,-3,-14,64,78,0,0.671582468834926
2008,8905,5167,0,5,3,75,72,1,7.19947427285213
2008,5100,5269,0,4,18,92,74,1,6.43892753538909
2008,7023,5269,0,1,-11,54,65,0,-0.655289509800046
2008,8769,5269,0,-7,-11,61,72,0,-8.11637966912814
2008,5100,5371,0,7,3,77,74,1,9.98778828269315
2008,6819,5371,0,-1,-7,69,76,0,-0.423243353112801
2008,9425,5674,0,15,41,70,29,1,37.4833888519834
2008,1835,5704,0,0,-9,60,69,0,-11.2667006434686
2008,6304,5704,0,15,39,113,74,1,26.1363977826676
2008,433,6304,0,-8,-31,77,108,0,-10.4037062442138
2008,4172,6304,0,0,18,84,66,1,3.93957211246481
2008,4619,6304,0,-2,-10,73,83,0,-5.17177539623706
2008,5704,6304,0,-15,-39,74,113,0,-26.1363977826654
2008,10423,6304,0,-3,-21,47,68,0,-6.75320741395616
2008,3121,6565,0,-7,-18,50,68,0,-9.62628501025834
2008,10423,6565,0,1,20,61,41,1,0.27444843974305
2008,4619,6687,0,3,30,78,48,1,5.13706983000447
2008,8462,6687,0,-5,-8,64,72,0,-2.87930458810139
2008,7023,6785,0,9,19,82,63,1,9.01493458436731
2008,5371,6819,0,1,7,76,69,1,0.423243353113106
2008,5269,7023,0,-1,11,65,54,1,0.655289509799623
2008,6785,7023,0,-9,-19,63,82,0,-9.01493458436659
2008,4172,7077,0,15,24,85,61,1,24.8915708257341
2008,645,7224,0,-5,-11,79,90,0,-0.842639920833971
2008,10809,7224,0,3,7,85,78,1,4.54480469785246
2008,1802,7682,0,9,-1,69,70,0,13.3802024226939
2008,10247,7682,0,1,9,72,63,1,6.38958119909406
2008,9975,8048,0,9,-21,62,83,0,8.26061589980341
2008,10043,8048,0,1,12,84,72,1,6.96654459742844
2008,1036,8116,0,3,20,81,61,1,5.11279520662778
2008,6687,8462,0,5,8,72,64,1,2.87930458810085
2008,5167,8530,0,3,14,78,64,1,-0.671582468835847
2008,1869,8598,0,-11,-24,53,77,0,-16.0943390415748
2008,4896,8598,0,-3,-1,81,82,0,1.30439391151652
2008,8905,8598,0,1,20,82,62,1,1.45072010328556
2008,5269,8769,0,7,11,72,61,1,8.11637966912526
2008,243,8803,0,-13,-15,57,72,0,-21.3806933736987
2008,1036,8803,0,-5,-5,71,76,0,-7.06418165913343
2008,4619,8803,0,-1,19,79,60,1,-1.32408522877907
2008,577,8905,0,-13,-20,54,74,0,-21.2539275797716
2008,5100,8905,0,1,18,85,67,1,4.38350900754549
2008,5167,8905,0,-5,-3,72,75,0,-7.19947427285254
2008,8598,8905,0,-1,-20,62,82,0,-1.45072010328502
2008,1070,8939,0,1,-5,62,67,0,-4.41288134396516
2008,9425,8939,0,8,2,51,49,1,5.8515760436761
2008,5100,9425,0,0,15,78,63,1,0.546411109062639
2008,5674,9425,0,-15,-41,29,70,0,-37.4833888519827
2008,8939,9425,0,-8,-2,49,51,0,-5.85157604367614
2008,10247,9425,0,-11,-10,78,88,0,-13.4299861205559
2008,10809,9425,0,-2,-19,57,76,0,-4.84816648197305
2008,3155,9525,0,13,19,66,47,1,18.8450427038927
2008,4172,9652,0,7,19,75,56,1,16.6767627968384
2008,4253,9652,0,-1,-13,58,71,0,-2.24337123330909
2008,4206,9686,0,-5,13,80,67,1,1.9169273726553
2008,5100,9720,0,15,24,87,63,1,25.8286690484683
2008,8048,9975,0,-9,21,83,62,1,-8.2606158998039
2008,1539,10043,0,7,-6,69,75,0,7.33722290386853
2008,4172,10043,0,11,15,72,57,1,16.6095596979057
2008,8048,10043,0,-1,-12,72,84,0,-6.96654459742848
2008,2295,10247,0,7,-2,99,101,0,5.44001438569297
2008,7682,10247,0,-1,-9,63,72,0,-6.38958119909364
2008,9425,10247,0,11,10,88,78,1,13.4299861205563
2008,6304,10423,0,3,21,68,47,1,6.75320741395913
2008,6565,10423,0,-1,-20,41,61,0,-0.274448439741725
2008,10653,10423,0,-9,-31,40,71,0,-12.1945696149211
2008,311,10491,0,-3,-10,65,75,0,-2.33883111305731
2008,2363,10491,0,5,-6,67,73,0,5.04316160120911
2008,10809,10491,0,4,4,79,75,1,-0.167522800160437
2008,10423,10653,0,9,31,71,40,1,12.1945696149208
2008,1948,10687,0,-11,-15,56,71,0,-14.8273586781252
2008,2071,10687,0,-7,17,73,56,1,-7.64599846660376
2008,4206,10687,0,-8,-17,55,72,0,-3.48311109670137
2008,3189,10809,0,-11,-12,61,73,0,-10.5462627724353
2008,7224,10809,0,-3,-7,78,85,0,-4.54480469785352
2008,9425,10809,0,2,19,76,57,1,4.8481664819745
2008,10491,10809,0,-4,-4,75,79,0,0.167522800161301
2009,3292,63,0,9,13,77,64,1,16.6046438034018
2009,5605,150,0,0,15,58,43,1,1.80713426126967
2009,10044,244,0,11,13,80,67,1,16.7615513235727
2009,1574,312,0,-1,-14,57,71,0,-5.94410241530079
2009,4620,312,0,11,39,103,64,1,8.20283369102858
2009,9789,312,0,7,-13,71,84,0,0.869086498933008
2009,8686,346,0,3,11,78,67,1,-0.00768522700976604
2009,8770,346,0,-5,-9,57,66,0,-8.53208963871697
2009,2364,716,0,13,24,86,62,1,24.3913664593056
2009,9687,788,0,-3,17,72,55,1,3.72650514521668
2009,4756,1037,0,1,4,75,71,1,1.89487581088146
2009,8940,1071,0,-1,13,79,66,1,-5.95975872236501
2009,4965,1163,0,-3,13,84,71,1,-3.15457729564082
2009,1803,1404,0,15,56,103,47,1,26.4533953699087
2009,5236,1540,0,-3,3,62,59,1,-4.9938516083143
2009,312,1574,0,1,14,71,57,1,5.94410241530784
2009,10356,1574,0,9,-15,69,84,0,10.0045686491355
2009,1404,1803,0,-15,-56,47,103,0,-26.4533953699001
2009,5270,1803,0,-1,9,82,73,1,-3.93312567010253
2009,5406,1803,0,-2,-7,75,82,0,-1.18293474213118
2009,7225,1803,0,-4,-12,60,72,0,-4.23759999066545
2009,8940,1803,0,-8,-26,66,92,0,-10.7067383167309
2009,5406,1870,0,11,19,78,59,1,16.7862169852366
2009,5101,1977,0,13,11,81,70,1,19.2310019288619
2009,4173,2106,0,8,17,60,43,1,11.7913626403003
2009,10492,2106,0,5,-8,60,68,0,12.6302799690122
2009,716,2364,0,-13,-24,62,86,0,-24.3913664593105
2009,8906,2364,0,-5,-5,69,74,0,-6.48344653887282
2009,10044,2364,0,-1,23,77,54,1,-4.65355881370526
2009,7024,2631,0,15,10,72,62,1,20.628903559161
2009,10688,2902,0,-7,2,61,59,1,1.07740581419028
2009,63,3292,0,-9,-13,64,77,0,-16.6046438033966
2009,6305,3292,0,3,21,98,77,1,4.39492625799234
2009,10248,3292,0,-8,-2,81,83,0,-16.995458047294
2009,10248,3769,0,-7,4,76,72,1,-11.9975178241562
2009,2106,4173,0,-8,-17,43,60,0,-11.7913626403038
2009,5270,4173,0,1,5,67,62,1,-1.48170194030693
2009,5800,4173,0,-11,-10,74,84,0,-11.8250430600463
2009,312,4620,0,-11,-39,64,103,0,-8.20283369102093
2009,5270,4620,0,-1,12,64,52,1,-3.8730953753993
2009,5605,4620,0,-15,-20,54,74,0,-24.5688541304345
2009,8049,4620,0,-8,-7,72,79,0,-13.1450624517081
2009,1037,4756,0,-1,-4,71,75,0,-1.89487581087762
2009,6305,4756,0,7,14,84,70,1,12.2058276340578
2009,5406,4897,0,3,4,83,79,1,4.05060802227156
2009,9823,4897,0,-5,-1,57,58,0,-5.90521747419222
2009,1163,4965,0,3,-13,71,84,0,3.15457729564251
2009,5101,4965,0,8,19,89,70,1,10.6401314484735
2009,1977,5101,0,-13,-11,70,81,0,-19.2310019288601
2009,4965,5101,0,-8,-19,70,89,0,-10.6401314484733
2009,5406,5101,0,-1,11,102,91,1,-1.87867408424937
2009,1540,5236,0,3,-3,59,62,0,4.99385160832178
2009,6688,5236,0,8,10,73,63,1,6.43671409081828
2009,1803,5270,0,1,-9,73,82,0,3.93312567010365
2009,4173,5270,0,-1,-5,62,67,0,1.48170194030098
2009,4620,5270,0,1,-12,52,64,0,3.87309537539727
2009,6305,5270,0,1,17,89,72,1,7.29730636798806
2009,7449,5270,0,-13,-15,62,77,0,-17.5812821801344
2009,9687,5270,0,-8,-5,69,74,0,-2.7284806051042
2009,8906,5304,0,3,14,76,62,1,2.84606731597509
2009,10390,5372,0,9,13,71,58,1,7.83218424352775
2009,1803,5406,0,2,7,82,75,1,1.18293474213849
2009,1870,5406,0,-11,-19,59,78,0,-16.7862169852376
2009,4897,5406,0,-3,-4,79,83,0,-4.0506080222752
2009,5101,5406,0,1,-11,91,102,0,1.87867408425228
2009,150,5605,0,0,-15,43,58,0,-1.80713426126841
2009,4620,5605,0,15,20,74,54,1,24.568854130437
2009,6688,5639,0,13,28,82,54,1,19.8989120729759
2009,4173,5800,0,11,10,84,74,1,11.8250430600432
2009,3292,6305,0,-3,-21,77,98,0,-4.39492625799415
2009,4756,6305,0,-7,-14,70,84,0,-12.2058276340614
2009,5270,6305,0,-1,-17,72,89,0,-7.29730636799713
2009,6688,6305,0,-1,-12,60,72,0,-6.68652946511563
2009,7279,6305,0,-15,-43,58,101,0,-27.4327460099012
2009,10044,6305,0,-2,-14,69,83,0,-7.92435807210229
2009,7225,6464,0,7,5,61,56,1,11.1131737770018
2009,8049,6653,0,-1,2,74,72,1,-4.8706382744064
2009,5236,6688,0,-8,-10,63,73,0,-6.43671409081906
2009,5639,6688,0,-13,-28,54,82,0,-19.8989120729777
2009,6305,6688,0,1,12,72,60,1,6.68652946510871
2009,8686,6688,0,-1,-13,71,84,0,-0.186870295513774
2009,7024,6722,0,7,8,84,76,1,7.91060058013136
2009,8804,6722,0,-1,-2,75,77,0,0.143583363783009
2009,2631,7024,0,-15,-10,62,72,0,-20.6289035591646
2009,6722,7024,0,-7,-8,76,84,0,-7.91060058013413
2009,10044,7024,0,-2,2,78,76,1,-5.4284466195137
2009,10810,7024,0,-3,-5,55,60,0,-7.82196322223116
2009,10810,7078,0,9,18,77,59,1,11.7936749333378
2009,1803,7225,0,4,12,72,60,1,4.23759999067238
2009,6464,7225,0,-7,-5,56,61,0,-11.1131737769988
2009,10390,7225,0,1,-2,74,76,0,0.666819476355041
2009,6305,7279,0,15,43,101,58,1,27.4327460098967
2009,5270,7449,0,13,15,77,62,1,17.5812821801306
2009,8686,8015,0,11,15,59,44,1,15.8252102454754
2009,4620,8049,0,8,7,79,72,1,13.1450624517104
2009,6653,8049,0,1,-2,72,74,0,4.8706382744068
2009,346,8686,0,-3,-11,67,78,0,0.00768522700401775
2009,6688,8686,0,1,13,84,71,1,0.186870295512168
2009,8015,8686,0,-11,-15,44,59,0,-15.8252102454751
2009,346,8770,0,5,9,66,57,1,8.53208963871065
2009,6722,8804,0,1,2,77,75,1,-0.143583363783726
2009,2364,8906,0,5,5,74,69,1,6.4834465388686
2009,5304,8906,0,-3,-14,62,76,0,-2.84606731597756
2009,1071,8940,0,1,-13,66,79,0,5.95975872236259
2009,1803,8940,0,8,26,92,66,1,10.7067383167366
2009,9908,9426,0,-5,-1,64,65,0,-12.8318012142633
2009,10044,9426,0,3,20,89,69,1,-3.61482812177832
2009,788,9687,0,3,-17,55,72,0,-3.72650514521989
2009,5270,9687,0,8,5,74,69,1,2.72848060510006
2009,312,9789,0,-7,13,84,71,1,-0.86908649892767
2009,4897,9823,0,5,1,58,57,1,5.90521747418653
2009,9426,9908,0,5,1,65,64,1,12.8318012142616
2009,244,10044,0,-11,-13,67,80,0,-16.7615513235724
2009,2364,10044,0,1,-23,54,77,0,4.65355881370261
2009,6305,10044,0,2,14,83,69,1,7.92435807209835
2009,7024,10044,0,2,-2,76,78,0,5.42844661951335
2009,9426,10044,0,-3,-20,69,89,0,3.6148281217778
2009,3292,10248,0,8,2,83,81,1,16.9954580472972
2009,3769,10248,0,7,-4,72,76,0,11.9975178241543
2009,1574,10356,0,-9,15,84,69,1,-10.0045686491345
2009,5372,10390,0,-9,-13,58,71,0,-7.83218424352795
2009,7225,10390,0,-1,2,76,74,1,-0.666819476353982
2009,2106,10492,0,-5,8,68,60,1,-12.6302799690138
2009,2902,10688,0,7,-2,59,61,0,-1.07740581418753
2009,10810,10688,0,8,11,60,49,1,1.27322040293151
2009,7024,10810,0,3,5,60,55,1,7.82196322222947
2009,7078,10810,0,-9,-18,59,77,0,-11.7936749333388
2009,10688,10810,0,-8,-11,49,60,0,-1.27322040293135
2010,2365,401,0,15,29,73,44,1,34.0979740467591
2010,10655,401,0,0,-17,44,61,0,1.47778521396171
2010,2365,647,0,2,7,78,71,1,7.67810795258811
2010,6757,647,0,-8,-8,68,76,0,-6.18348960653975
2010,7616,647,0,-11,-9,59,68,0,-14.5707352640847
2010,8532,647,0,-7,-23,49,72,0,-3.88724940679226
2010,2365,1038,0,4,2,61,59,1,12.6768733025409
2010,4208,1038,0,3,-7,56,63,0,7.31259768797289
2010,5271,1038,0,0,-2,50,52,0,3.60817596236567
2010,5774,1038,0,-8,-2,52,54,0,-4.27246132575896
2010,8687,1038,0,4,-4,59,63,0,9.30770831299997
2010,9872,1038,0,-7,-18,59,77,0,0.781089114044132
2010,2804,1072,0,-3,-7,92,99,0,-7.06328961684144
2010,4208,1072,0,5,12,84,72,1,0.538852819715441
2010,2365,1164,0,7,15,68,53,1,7.89534365632733
2010,4621,1164,0,-1,-15,62,77,0,-2.75190916773992
2010,5407,1541,0,-3,8,86,78,1,1.24830397162715
2010,4289,1871,0,11,17,62,45,1,14.0388422305145
2010,8771,1871,0,7,-13,65,78,0,6.32938164693981
2010,10689,1871,0,8,-18,69,87,0,12.9269534135516
2010,401,2365,0,-15,-29,44,73,0,-34.0979740467632
2010,647,2365,0,-2,-7,71,78,0,-7.6781079525949
2010,1038,2365,0,-4,-2,59,61,0,-12.6768733025387
2010,1164,2365,0,-7,-15,53,68,0,-7.89534365633251
2010,7226,2365,0,-3,-13,57,70,0,-7.50367895316936
2010,10493,2365,0,-1,-21,57,78,0,-6.35473801713549
2010,4289,2632,0,15,29,100,71,1,21.6855482632001
2010,1072,2804,0,3,7,99,92,1,7.06328961683679
2010,3293,2903,0,1,7,67,60,1,-2.69472619725811
2010,6620,3157,0,-11,14,97,83,1,-14.2623592948515
2010,6654,3259,0,8,9,75,66,1,5.25653372005513
2010,6723,3259,0,3,-5,59,64,0,-1.77982837786684
2010,2903,3293,0,-1,-7,60,67,0,2.69472619725581
2010,8687,3293,0,7,22,87,65,1,9.37184862362518
2010,4966,3584,0,9,12,89,77,1,11.3962759261531
2010,4425,4174,0,-15,-16,74,90,0,-30.0641178193681
2010,6465,4174,0,-8,2,69,67,1,-14.9441146156446
2010,1038,4208,0,-3,7,63,56,1,-7.31259768796882
2010,1072,4208,0,-5,-12,72,84,0,-0.538852819719157
2010,6363,4208,0,-13,-20,62,82,0,-22.1393862542263
2010,10811,4208,0,-4,-5,96,101,0,-4.24805996228406
2010,1871,4289,0,-11,-17,45,62,0,-14.0388422305139
2010,2632,4289,0,-15,-29,71,100,0,-21.6855482632
2010,10357,4289,0,-8,-30,60,90,0,-8.52344163246128
2010,10493,4289,0,-1,7,73,66,1,-1.6416739837962
2010,4174,4425,0,15,16,90,74,1,30.0641178193724
2010,1164,4621,0,1,15,77,62,1,2.75190916773616
2010,10391,4898,0,-5,2,80,78,1,0.643874295047475
2010,3584,4966,0,-9,-12,77,89,0,-11.3962759261519
2010,5271,4966,0,-1,2,85,83,1,-2.309824048406
2010,1038,5271,0,0,2,52,50,1,-3.60817596235655
2010,4966,5271,0,1,-2,83,85,0,2.30982404841099
2010,6139,5271,0,-7,-3,67,70,0,-14.264158417607
2010,6465,5271,0,-4,-7,52,59,0,-5.22341031805047
2010,8805,5271,0,-1,-1,69,70,0,-0.22809779035838
2010,10811,5305,0,5,11,65,54,1,-0.580613960029691
2010,1541,5407,0,3,-8,78,86,0,-1.24830397162423
2010,10493,5407,0,8,9,68,59,1,1.25224384753092
2010,6105,5538,0,11,5,62,57,1,9.40758711825074
2010,10493,5640,0,13,27,77,50,1,20.3985349794097
2010,1038,5774,0,8,2,54,52,1,4.2724613257643
2010,9977,5774,0,9,-1,65,66,0,7.25588538056332
2010,5538,6105,0,-11,-5,57,62,0,-9.40758711825202
2010,10391,6105,0,-8,18,82,64,1,3.16784848373949
2010,5271,6139,0,7,3,70,67,1,14.2641584176096
2010,4208,6363,0,13,20,82,62,1,22.1393862542239
2010,4174,6465,0,8,-2,67,69,0,14.9441146156536
2010,5271,6465,0,4,7,59,52,1,5.22341031805615
2010,9654,6465,0,1,-3,66,69,0,2.12269210808888
2010,6757,6567,0,-5,1,51,50,1,-2.0283973525577
2010,7025,6586,0,11,23,89,66,1,13.7147155483324
2010,3157,6620,0,11,-14,83,97,0,14.2623592948489
2010,8805,6620,0,8,15,83,68,1,12.2245049368089
2010,3259,6654,0,-8,-9,66,75,0,-5.25653372005764
2010,7819,6654,0,-13,-17,51,68,0,-20.1332537839239
2010,8805,6654,0,-4,3,76,73,1,-3.72551490021714
2010,3259,6723,0,-3,5,64,59,1,1.77982837786263
2010,647,6757,0,8,8,76,68,1,6.18348960653628
2010,6567,6757,0,5,-1,50,51,0,2.02839735255752
2010,6586,7025,0,-11,-23,66,89,0,-13.7147155483334
2010,10811,7025,0,-3,3,71,68,1,1.46008501425802
2010,2365,7226,0,3,13,70,57,1,7.50367895316497
2010,8050,7226,0,-9,-8,64,72,0,-9.53160698850455
2010,8941,7226,0,-1,-2,61,63,0,-2.47598146793377
2010,8532,7382,0,-3,9,80,71,1,3.60716770543872
2010,10045,7450,0,13,3,73,70,1,22.5703134008673
2010,647,7616,0,11,9,68,59,1,14.5707352640807
2010,8805,7718,0,5,3,62,59,1,4.48550327714968
2010,6654,7819,0,13,17,68,51,1,20.1332537839256
2010,7226,8050,0,9,8,72,64,1,9.53160698850248
2010,647,8532,0,7,23,72,49,1,3.88724940679047
2010,7382,8532,0,3,-9,71,80,0,-3.60716770543695
2010,10045,8532,0,8,-7,68,75,0,4.04068543995662
2010,1038,8687,0,-4,4,63,59,1,-9.30770831299306
2010,3293,8687,0,-7,-22,65,87,0,-9.37184862362474
2010,10011,8687,0,-15,-23,56,79,0,-23.6144671394954
2010,1871,8771,0,-7,13,78,65,1,-6.32938164693997
2010,5271,8805,0,1,1,70,69,1,0.228097790362053
2010,6620,8805,0,-8,-15,68,83,0,-12.2245049368084
2010,6654,8805,0,4,-3,73,76,0,3.72551490021889
2010,7718,8805,0,-5,-3,59,62,0,-4.48550327715022
2010,10357,8907,0,-1,1,81,80,1,-6.92522236422591
2010,7226,8941,0,1,2,63,61,1,2.47598146793111
2010,9824,8941,0,-7,-16,53,69,0,-1.37494663795818
2010,6465,9654,0,-1,3,69,66,1,-2.12269210808662
2010,8941,9824,0,7,16,69,53,1,1.3749466379562
2010,1038,9872,0,7,18,77,59,1,-0.781089114037911
2010,5774,9977,0,-9,1,66,65,1,-7.2558853805634
2010,8687,10011,0,15,23,79,56,1,23.6144671394966
2010,7450,10045,0,-13,-3,70,73,0,-22.5703134008672
2010,8532,10045,0,-8,7,75,68,1,-4.04068543995581
2010,4289,10357,0,8,30,90,60,1,8.52344163246292
2010,8907,10357,0,1,-1,80,81,0,6.92522236422624
2010,4898,10391,0,5,-2,78,80,0,-0.643874295047237
2010,6105,10391,0,8,-18,64,82,0,-3.16784848374118
2010,10493,10391,0,9,13,69,56,1,2.52518558358589
2010,2365,10493,0,1,21,78,57,1,6.35473801713215
2010,4289,10493,0,1,-7,66,73,0,1.64167398379687
2010,5407,10493,0,-8,-9,59,68,0,-1.25224384753312
2010,5640,10493,0,-13,-27,50,77,0,-20.3985349794083
2010,10391,10493,0,-9,-13,56,69,0,-2.52518558358635
2010,401,10655,0,0,17,61,44,1,-1.47778521396249
2010,1871,10689,0,-8,18,87,69,1,-12.9269534135514
2010,10712,10689,0,-9,-4,49,53,0,-15.7799774555141
2010,10689,10712,0,9,4,53,49,1,15.7799774555147
2010,4208,10811,0,4,5,101,96,1,4.24805996228344
2010,5305,10811,0,-5,-11,54,65,0,0.580613960028465
2010,7025,10811,0,3,-3,68,71,0,-1.46008501425845
2011,6568,65,0,13,13,69,56,1,16.9406070270691
2011,9757,152,0,0,9,70,61,1,7.49628016780869
2011,1805,314,0,2,2,65,63,1,0.85170713407771
2011,2366,314,0,4,-16,77,93,0,8.79975085565593
2011,5103,314,0,-7,-2,75,77,0,-9.34464692978639
2011,8908,314,0,1,-1,69,70,0,5.22670273106834
2011,9560,382,0,0,4,81,77,1,3.64612240043649
2011,10690,667,0,9,14,72,58,1,5.66807473960182
2011,4175,824,0,15,19,72,53,1,27.5384059976106
2011,1805,978,0,11,29,81,52,1,14.1416052107154
2011,1805,1039,0,5,12,53,41,1,6.52274492385011
2011,2805,1039,0,6,-3,71,74,0,5.06296136590755
2011,6758,1039,0,-1,-2,58,60,0,-1.74765339291067
2011,7026,1039,0,7,-1,70,71,0,10.7491468262469
2011,9910,1039,0,-3,-8,62,70,0,-4.94452370210874
2011,10690,1039,0,4,-7,54,61,0,8.30665423018341
2011,2805,1073,0,1,9,83,74,1,-3.24230856046868
2011,3294,1073,0,-8,-22,67,89,0,-4.80065979164732
2011,10713,1073,0,-11,-8,66,74,0,-14.9263132640041
2011,1805,1474,0,3,11,69,58,1,1.59268394194521
2011,5408,1474,0,-5,-15,63,78,0,0.00366745831315995
2011,9295,1542,0,0,-18,52,70,0,-4.41923319147796
2011,10494,1542,0,7,8,84,76,1,2.884484027308
2011,314,1805,0,-2,-2,63,65,0,-0.851707134077753
2011,978,1805,0,-11,-29,52,81,0,-14.1416052107144
2011,1039,1805,0,-5,-12,41,53,0,-6.5227449238534
2011,1474,1805,0,-3,-11,58,69,0,-1.59268394194833
2011,4290,1805,0,-1,-1,55,56,0,3.17840814208931
2011,7719,1805,0,1,-7,67,74,0,1.22911430024171
2011,314,2366,0,-4,16,93,77,1,-8.79975085565497
2011,3356,2366,0,-15,-42,45,87,0,-29.7921258674008
2011,5238,2366,0,-7,-2,71,73,0,-11.9656387381992
2011,1039,2805,0,-6,3,74,71,1,-5.06296136591377
2011,1073,2805,0,-1,-9,74,83,0,3.24230856046271
2011,7820,2805,0,-13,-28,51,79,0,-13.7374530785363
2011,9428,2805,0,-5,-8,65,73,0,-3.70893810985429
2011,6568,2904,0,8,-14,57,71,0,6.22108401435745
2011,8942,2904,0,3,-7,50,57,0,0.367399742475863
2011,9910,2904,0,-1,1,72,71,1,-7.14599691376819
2011,6655,3124,0,7,32,98,66,1,13.6417855240345
2011,10046,3124,0,-1,-4,57,61,0,3.74341114874926
2011,9910,3158,0,-5,18,74,56,1,-9.93608551113056
2011,10392,3192,0,3,3,68,65,1,10.5046819452956
2011,1073,3294,0,8,22,89,67,1,4.80065979164312
2011,8431,3294,0,5,-15,71,86,0,-0.31295507081485
2011,2366,3356,0,15,42,87,45,1,29.7921258674035
2011,4175,3771,0,8,14,73,59,1,8.37557160615724
2011,9655,3771,0,1,-11,62,73,0,-1.33103029538213
2011,8688,3878,0,11,17,77,60,1,16.3777650473949
2011,824,4175,0,-15,-19,53,72,0,-27.5384059976146
2011,3771,4175,0,-8,-14,59,73,0,-8.37557160616365
2011,7383,4175,0,-11,-20,57,77,0,-13.9225377634369
2011,9910,4175,0,-10,10,71,61,1,-19.3099872665121
2011,9825,4209,0,-7,-5,68,73,0,-1.25251104586497
2011,10690,4209,0,1,5,70,65,1,4.05803445188998
2011,1805,4290,0,1,1,56,55,1,-3.17840814209075
2011,6307,4290,0,2,-7,69,76,0,-1.75558921805781
2011,6655,4290,0,3,-2,60,62,0,5.14562359173139
2011,7159,4290,0,-9,-2,57,59,0,-16.8709563750778
2011,10494,4290,0,-1,-8,63,71,0,-3.95934005603984
2011,6307,4540,0,13,15,102,87,1,16.2500178309864
2011,5607,4622,0,-9,1,62,61,1,-16.8689271901157
2011,6307,4899,0,9,18,81,63,1,3.4633193357306
2011,8688,4899,0,8,-4,62,66,0,4.09874288654821
2011,10812,4899,0,5,-11,55,66,0,-2.88682535094533
2011,314,5103,0,7,2,77,75,1,9.34464692978734
2011,2366,5238,0,7,2,73,71,1,11.9656387382006
2011,8806,5238,0,-1,-30,45,75,0,-1.38018317147246
2011,9428,5272,0,3,2,78,76,1,-1.8327512592673
2011,1474,5408,0,5,15,78,63,1,-0.00366745831589554
2011,4622,5607,0,9,-1,61,62,0,16.8689271901162
2011,7383,5607,0,1,17,65,48,1,8.67192341328046
2011,7719,5789,0,13,18,68,50,1,16.7599846073522
2011,4290,6307,0,-2,7,76,69,1,1.75558921805365
2011,4540,6307,0,-13,-15,87,102,0,-16.2500178309874
2011,4899,6307,0,-9,-18,63,81,0,-3.46331933573455
2011,10392,6307,0,-5,-3,83,86,0,2.20933579606789
2011,65,6568,0,-13,-13,56,69,0,-16.9406070270745
2011,2904,6568,0,-8,14,71,57,1,-6.22108401436105
2011,8908,6587,0,9,4,85,81,1,13.4345455268438
2011,3124,6655,0,-7,-32,66,98,0,-13.641785524032
2011,4290,6655,0,-3,2,62,60,1,-5.1456235917303
2011,9757,6655,0,-15,-29,46,75,0,-31.294857961066
2011,1039,6758,0,1,2,60,58,1,1.74765339290645
2011,8772,6958,0,3,2,66,64,1,0.576989775285584
2011,1039,7026,0,-7,1,71,70,1,-10.7491468262519
2011,9560,7026,0,-15,-23,51,74,0,-21.910413353186
2011,4290,7159,0,9,2,59,57,1,16.870956375076
2011,8567,7227,0,-11,-22,43,65,0,-20.0378387080659
2011,9910,7227,0,-8,18,94,76,1,-14.3846738796727
2011,4175,7383,0,11,20,77,57,1,13.9225377634322
2011,5607,7383,0,-1,-17,48,65,0,-8.67192341328003
2011,9978,7383,0,7,-3,66,69,0,4.26432388577035
2011,1805,7719,0,-1,7,74,67,1,-1.22911430024308
2011,5789,7719,0,-13,-18,50,68,0,-16.7599846073542
2011,8772,7719,0,-5,-7,64,71,0,-5.80185449477924
2011,2805,7820,0,13,28,79,51,1,13.7374530785336
2011,3294,8431,0,-5,15,86,71,1,0.312955070814095
2011,7227,8567,0,11,22,65,43,1,20.0378387080685
2011,3878,8688,0,-11,-17,60,77,0,-16.3777650473922
2011,4899,8688,0,-8,4,66,62,1,-4.09874288654858
2011,6958,8772,0,-3,-2,64,66,0,-0.576989775285059
2011,7719,8772,0,5,7,71,64,1,5.80185449477826
2011,5238,8806,0,1,30,75,45,1,1.38018317147223
2011,314,8908,0,-1,1,70,69,1,-5.22670273106902
2011,6587,8908,0,-9,-4,81,85,0,-13.434545526844
2011,2904,8942,0,-3,7,57,50,1,-0.367399742476543
2011,1542,9295,0,0,18,70,52,1,4.41923319148007
2011,2805,9428,0,5,8,73,65,1,3.70893810985196
2011,5272,9428,0,-3,-2,76,78,0,1.83275125926811
2011,382,9560,0,0,-4,77,81,0,-3.64612240043635
2011,7026,9560,0,15,23,74,51,1,21.9104133531844
2011,3771,9655,0,-1,11,73,62,1,1.33103029538026
2011,9910,9689,0,0,13,59,46,1,-6.68039768750307
2011,152,9757,0,0,-9,61,70,0,-7.4962801677998
2011,6655,9757,0,15,29,75,46,1,31.294857961069
2011,4209,9825,0,7,5,73,68,1,1.25251104586772
2011,1039,9910,0,3,8,70,62,1,4.94452370210553
2011,2904,9910,0,1,-1,71,72,0,7.14599691376721
2011,3158,9910,0,5,-18,56,74,0,9.93608551113201
2011,4175,9910,0,10,-10,61,71,0,19.3099872665077
2011,7227,9910,0,8,-18,76,94,0,14.3846738796752
2011,9689,9910,0,0,-13,46,59,0,6.68039768750344
2011,7383,9978,0,-7,3,69,66,1,-4.26432388576979
2011,3124,10046,0,1,4,61,57,1,-3.74341114874983
2011,3192,10392,0,-3,-3,65,68,0,-10.5046819452967
2011,6307,10392,0,5,3,86,83,1,-2.20933579607036
2011,1542,10494,0,-7,-8,76,84,0,-2.88448402730606
2011,4290,10494,0,1,8,71,63,1,3.95934005603847
2011,667,10690,0,-9,-14,58,72,0,-5.66807473960592
2011,1039,10690,0,-4,7,61,54,1,-8.30665423018696
2011,4209,10690,0,-1,-5,65,70,0,-4.05803445188723
2011,1073,10713,0,11,8,74,66,1,14.9263132640005
2011,4899,10812,0,-5,11,66,55,1,2.88682535094322
2012,1907,100,0,1,1,58,57,1,-0.44467479588223
2012,1704,649,0,-8,-17,63,80,0,-9.32679453479364
2012,4291,649,0,2,12,82,70,1,7.66693586565878
2012,7533,649,0,-11,-8,60,68,0,-9.60869296101291
2012,10813,649,0,-7,-5,70,75,0,-7.74304459015831
2012,3159,668,0,11,15,74,59,1,4.61960585659888
2012,3913,1074,0,0,-6,72,78,0,-3.14342590739442
2012,4900,1074,0,11,20,88,68,1,5.20919336514719
2012,8198,1166,0,0,11,65,54,1,-5.44549911417387
2012,2905,1475,0,3,-6,56,62,0,2.56532230865102
2012,6656,1475,0,4,15,81,66,1,11.7543548697869
2012,8909,1475,0,-5,-6,59,65,0,1.88121235425813
2012,649,1704,0,8,17,80,63,1,9.32679453479753
2012,9656,1704,0,5,-4,64,68,0,6.68326076007767
2012,5776,1738,0,5,17,58,41,1,1.07911634540806
2012,3981,1806,0,1,13,77,64,1,0.732321743387926
2012,100,1907,0,-1,-1,57,58,0,0.444674795876665
2012,6308,1907,0,7,14,87,73,1,8.60244443234683
2012,4623,2075,0,9,7,69,62,1,8.16949061113235
2012,4176,2265,0,13,15,65,50,1,19.6333302878484
2012,4427,2367,0,-13,5,75,70,1,-13.9956941063592
2012,4623,2806,0,3,4,72,68,1,-1.83579751239372
2012,4900,2806,0,4,-10,58,68,0,-0.622347705677338
2012,6274,2806,0,-8,-34,50,84,0,-21.3874431774871
2012,10081,2806,0,-3,-26,45,71,0,-3.92850468507078
2012,1475,2905,0,-3,6,62,56,1,-2.565322308651
2012,8330,2905,0,-11,-3,63,66,0,-7.06890835053831
2012,668,3159,0,-11,-15,59,74,0,-4.61960585660323
2012,5956,3159,0,-8,3,66,63,1,-5.16041892944627
2012,6656,3295,0,5,7,73,66,1,11.3290889756553
2012,10495,3295,0,-3,-23,54,77,0,-0.117304442787091
2012,9979,3431,0,7,9,79,70,1,7.59277885707318
2012,4291,3845,0,3,12,102,90,1,5.41400253041889
2012,6141,3845,0,-9,-13,66,79,0,-10.269685691608
2012,9911,3845,0,-8,-2,61,63,0,-11.0319266535233
2012,1074,3913,0,0,6,78,72,1,3.1434259073926
2012,1806,3981,0,-1,-13,64,77,0,-0.732321743382624
2012,4291,3981,0,7,16,87,71,1,11.1310097246689
2012,2265,4176,0,-13,-15,50,65,0,-19.6333302878435
2012,4291,4176,0,1,8,67,59,1,2.48856636352673
2012,5956,4176,0,-9,-3,57,60,0,-10.4842784388032
2012,6308,4176,0,1,-13,67,80,0,-0.0212946686533471
2012,6656,4176,0,0,-2,62,64,0,2.30110105706401
2012,7228,4176,0,-8,-3,60,63,0,-8.05517120192069
2012,8232,4210,0,-1,-6,64,70,0,-7.05038496957435
2012,8689,4210,0,7,16,75,59,1,6.14041420796284
2012,649,4291,0,-2,-12,70,82,0,-7.66693586565689
2012,3845,4291,0,-3,-12,90,102,0,-5.41400253042013
2012,3981,4291,0,-7,-16,71,87,0,-11.1310097246687
2012,4176,4291,0,-1,-8,59,67,0,-2.48856636352481
2012,4623,4291,0,-3,-8,61,69,0,-9.09448427869014
2012,10251,4291,0,-15,-15,66,81,0,-27.4237479291367
2012,10013,4393,0,0,12,71,59,1,-2.61650454415547
2012,2367,4427,0,13,-5,70,75,0,13.9956941063582
2012,10813,4427,0,5,12,70,58,1,5.24248424050705
2012,6107,4507,0,7,7,75,68,1,6.21828764639518
2012,5273,4541,0,15,22,89,67,1,23.7100366528292
2012,2075,4623,0,-9,-7,62,69,0,-8.1694906111292
2012,2806,4623,0,-3,-4,68,72,0,1.8357975123905
2012,4291,4623,0,3,8,69,61,1,9.09448427868761
2012,5273,4623,0,3,-13,44,57,0,6.79616145159268
2012,6107,4623,0,-1,-3,56,59,0,0.472276744919077
2012,6656,4691,0,13,19,78,59,1,24.2911221043063
2012,1074,4900,0,-11,-20,68,88,0,-5.20919336514846
2012,2806,4900,0,-4,10,68,58,1,0.62234770567434
2012,5776,4900,0,-3,-9,53,62,0,-8.22177682935963
2012,8500,5104,0,-1,7,61,54,1,-2.58244141237886
2012,6622,5239,0,-9,5,65,60,1,-7.3294630874815
2012,4541,5273,0,-15,-22,67,89,0,-23.7100366528316
2012,4623,5273,0,-3,13,57,44,1,-6.79616145159397
2012,8500,5273,0,-8,-4,61,65,0,-7.48549404207896
2012,6274,5409,0,-13,2,86,84,1,-24.8177399393121
2012,10691,5540,0,9,24,73,49,1,14.0760081944644
2012,10251,5678,0,0,1,59,58,1,5.16034115262887
2012,1738,5776,0,-5,-17,41,58,0,-1.07911634540844
2012,4900,5776,0,3,9,62,53,1,8.22177682935867
2012,3159,5956,0,8,-3,63,66,0,5.16041892944413
2012,4176,5956,0,9,3,60,57,1,10.4842784388073
2012,7720,5956,0,5,-14,65,79,0,-1.81124400772214
2012,4507,6107,0,-7,-7,68,75,0,-6.21828764639151
2012,4623,6107,0,1,3,59,56,1,-0.472276744918057
2012,3845,6141,0,9,13,79,66,1,10.2696856916088
2012,2806,6274,0,8,34,84,50,1,21.3874431774839
2012,5409,6274,0,13,-2,84,86,0,24.8177399393121
2012,1907,6308,0,-7,-14,73,87,0,-8.60244443234874
2012,4176,6308,0,-1,13,80,67,1,0.0212946686566013
2012,6622,6308,0,-12,-8,65,73,0,-15.5170681821323
2012,10013,6308,0,-15,-19,58,77,0,-21.6201287914938
2012,10813,6569,0,-3,4,67,63,1,-2.20239936577287
2012,5239,6622,0,9,-5,60,65,0,7.3294630874822
2012,6308,6622,0,12,8,73,65,1,15.5170681821325
2012,8198,6622,0,1,-6,56,62,0,1.94472736756721
2012,1475,6656,0,-4,-15,66,81,0,-11.7543548697858
2012,3295,6656,0,-5,-7,66,73,0,-11.3290889756551
2012,4176,6656,0,0,2,64,62,1,-2.30110105706038
2012,4691,6656,0,-13,-19,59,78,0,-24.2911221043065
2012,8689,6656,0,1,-7,70,77,0,-3.13363120583226
2012,4176,7228,0,8,3,63,60,1,8.05517120192446
2012,8534,7228,0,3,-3,69,72,0,-2.77297315505983
2012,649,7533,0,11,8,68,60,1,9.60869296101724
2012,5956,7720,0,-5,14,79,65,1,1.81124400772359
2012,1166,8198,0,0,-11,54,65,0,5.44549911417334
2012,6622,8198,0,-1,6,62,56,1,-1.94472736756648
2012,8773,8198,0,7,-14,44,58,0,2.57774023644335
2012,4210,8232,0,1,6,70,64,1,7.05038496957434
2012,2905,8330,0,11,3,66,63,1,7.06890835053644
2012,5104,8500,0,1,-7,54,61,0,2.58244141237881
2012,5273,8500,0,8,4,65,61,1,7.48549404207785
2012,7228,8534,0,-3,3,72,69,1,2.77297315505855
2012,4210,8689,0,-7,-16,59,75,0,-6.14041420796546
2012,6656,8689,0,-1,7,77,70,1,3.13363120582996
2012,9561,8689,0,-15,-7,65,72,0,-18.5711419017043
2012,10691,8689,0,-3,-1,63,64,0,-2.16400415398592
2012,8198,8773,0,-7,14,58,44,1,-2.57774023644292
2012,1475,8909,0,5,6,65,59,1,-1.88121235425659
2012,8689,9561,0,15,7,72,65,1,18.5711419017029
2012,1704,9656,0,-5,4,68,64,1,-6.68326076007748
2012,3845,9911,0,8,2,63,61,1,11.0319266535249
2012,10591,9911,0,7,-3,59,62,0,10.0074839169242
2012,3431,9979,0,-7,-9,70,79,0,-7.59277885707127
2012,10691,9979,0,1,3,60,57,1,3.51226701198583
2012,4393,10013,0,0,-12,59,71,0,2.61650454415649
2012,6308,10013,0,15,19,77,58,1,21.6201287914932
2012,2806,10081,0,3,26,71,45,1,3.92850468506751
2012,4291,10251,0,15,15,81,66,1,27.4237479291345
2012,5678,10251,0,0,-1,58,59,0,-5.1603411526292
2012,3295,10495,0,3,23,77,54,1,0.117304442788509
2012,9911,10591,0,-7,3,62,59,1,-10.0074839169235
2012,5540,10691,0,-9,-24,49,73,0,-14.0760081944633
2012,8689,10691,0,3,1,64,63,1,2.16400415398444
2012,9979,10691,0,-1,-3,57,60,0,-3.51226701198521
2012,649,10813,0,7,5,75,70,1,7.74304459016167
2012,4427,10813,0,-5,-12,58,70,0,-5.24248424050909
2012,6569,10813,0,3,-4,63,67,0,2.2023993657731
2013,9912,67,0,7,46,88,42,1,6.77473161854627
2013,2368,173,0,13,12,73,61,1,22.9540041826268
2013,669,316,0,-5,-17,64,81,0,-6.02281998521279
2013,3432,316,0,-8,-23,51,74,0,-13.0571567139774
2013,6657,316,0,4,3,73,70,1,3.46675167478996
2013,316,669,0,5,17,81,64,1,6.02281998521463
2013,4326,758,0,0,9,80,71,1,-0.53767756886924
2013,1041,980,0,5,12,68,56,1,3.54257672442701
2013,980,1041,0,-5,-12,56,68,0,-3.54257672442656
2013,4901,1041,0,3,2,74,72,1,3.49211932947165
2013,8690,1167,0,8,6,66,60,1,8.68034188508468
2013,9657,1167,0,7,-3,61,64,0,3.07484080697865
2013,1908,1476,0,3,4,67,63,1,2.07977630929157
2013,3773,1705,0,3,8,57,49,1,0.870956097338254
2013,4624,1739,0,7,26,82,56,1,9.83524370631535
2013,5410,1739,0,-1,-12,72,84,0,1.68413422450809
2013,1476,1908,0,-3,-4,63,67,0,-2.07977630929181
2013,2368,1908,0,5,16,66,50,1,5.08120153083487
2013,4901,2076,0,11,1,59,58,1,7.09148882790746
2013,173,2368,0,-13,-12,61,73,0,-22.9540041826224
2013,1908,2368,0,-5,-16,50,66,0,-5.0812015308283
2013,4624,2368,0,1,22,85,63,1,2.3770804116995
2013,5274,2368,0,-1,-10,61,71,0,-3.29499151705359
2013,2807,2773,0,12,12,62,50,1,23.6519559948362
2013,3160,2773,0,13,-10,68,78,0,15.764546515049
2013,7721,2773,0,8,-10,71,81,0,12.9344294036751
2013,2773,2807,0,-12,-12,50,62,0,-23.6519559948315
2013,5240,2807,0,-1,20,79,59,1,-4.48313027964586
2013,5308,2807,0,-8,-14,64,78,0,-7.8937967124565
2013,6536,2807,0,-11,-32,47,79,0,-23.7809706933549
2013,2773,3160,0,-13,10,78,68,1,-15.7645465150482
2013,8267,3296,0,-15,-6,58,64,0,-24.5733046649202
2013,10592,3296,0,-8,6,76,70,1,-8.36146927033419
2013,316,3432,0,8,23,74,51,1,13.0571567139804
2013,6108,3432,0,11,-6,62,68,0,10.4751506199863
2013,1705,3773,0,-3,-8,49,57,0,-0.87095609734003
2013,5172,3773,0,5,4,63,59,1,3.93173501529698
2013,4143,3846,0,-15,-21,62,83,0,-28.0432635805013
2013,8690,3846,0,-3,11,61,50,1,-6.5494736316882
2013,8774,3846,0,-8,-6,52,58,0,-16.7991654360451
2013,6657,3914,0,13,25,95,70,1,15.965775628513
2013,6570,3982,0,3,-18,58,76,0,0.453142580717778
2013,6657,3982,0,8,3,78,75,1,6.50236535418253
2013,3846,4143,0,15,21,83,62,1,28.043263580503
2013,4542,4143,0,0,-13,55,68,0,-0.595464347512724
2013,5240,4177,0,-3,2,87,85,1,-0.997283837456948
2013,6309,4177,0,-7,-12,58,70,0,-6.30496883737374
2013,10252,4177,0,-15,-7,57,64,0,-22.054937720208
2013,4326,4211,0,-9,2,63,61,1,-3.83980587649378
2013,758,4326,0,0,-9,71,80,0,0.537677568868767
2013,4211,4326,0,9,-2,61,63,0,3.83980587649173
2013,5342,4326,0,1,-2,74,76,0,4.56889086272345
2013,10592,4326,0,4,14,72,58,1,3.21316920521992
2013,5912,4458,0,0,1,73,72,1,2.09289602766069
2013,4143,4542,0,0,13,68,55,1,0.595464347512404
2013,1739,4624,0,-7,-26,56,82,0,-9.83524370631816
2013,2368,4624,0,-1,-22,63,85,0,-2.37708041169745
2013,5240,4624,0,-3,-6,76,82,0,-4.07600498655684
2013,5912,4624,0,-15,-31,48,79,0,-31.0978836481569
2013,6824,4624,0,-11,-8,69,77,0,-11.1743006370789
2013,10592,4624,0,-8,-4,68,72,0,-11.0952997855544
2013,1041,4901,0,-3,-2,72,74,0,-3.49211932946983
2013,2076,4901,0,-11,-1,58,59,0,-7.09148882790771
2013,5172,4901,0,1,-10,61,71,0,2.70243199308621
2013,8690,4901,0,-1,16,55,39,1,4.92096662354511
2013,5274,5105,0,3,22,70,48,1,6.00324816019082
2013,8535,5105,0,-5,-2,52,54,0,2.11859193292751
2013,3773,5172,0,-5,-4,59,63,0,-3.93173501529877
2013,4901,5172,0,-1,10,71,61,1,-2.70243199308754
2013,6892,5172,0,-13,-29,49,78,0,-13.8588893676111
2013,2807,5240,0,1,-20,59,79,0,4.48313027964714
2013,4177,5240,0,3,-2,85,87,0,0.997283837457037
2013,4624,5240,0,3,6,82,76,1,4.07600498654968
2013,7534,5240,0,-9,-15,56,71,0,-17.6205010869991
2013,8690,5240,0,0,-5,56,61,0,-0.816906274406358
2013,9912,5240,0,-1,-25,53,78,0,-3.71858404803865
2013,2368,5274,0,1,10,71,61,1,3.29499151705872
2013,5105,5274,0,-3,-22,48,70,0,-6.00324816019167
2013,9946,5274,0,-11,-11,54,65,0,-11.2114085505148
2013,2807,5308,0,8,14,78,64,1,7.8937967124594
2013,9430,5308,0,5,-20,63,83,0,-3.06959187947863
2013,4326,5342,0,-1,2,76,74,1,-4.56889086272643
2013,10692,5342,0,7,-11,46,57,0,4.82875184172226
2013,1739,5410,0,1,12,84,72,1,-1.68413422450403
2013,8690,5541,0,9,47,81,34,1,19.7411183365766
2013,8535,5743,0,0,13,67,54,1,2.99645973728663
2013,4458,5912,0,0,-1,72,73,0,-2.09289602766165
2013,4624,5912,0,15,31,79,48,1,31.0978836481516
2013,8774,5957,0,-1,4,76,72,1,-5.70214387808453
2013,3432,6108,0,-11,6,68,62,1,-10.4751506199848
2013,8501,6142,0,9,20,64,44,1,8.80149425078251
2013,4177,6309,0,7,12,70,58,1,6.30496883737825
2013,10048,6309,0,-1,-7,71,78,0,-3.9151718065059
2013,2807,6536,0,11,32,79,47,1,23.7809706933586
2013,3982,6570,0,-3,18,76,58,1,-0.453142580718804
2013,316,6657,0,-4,-3,70,73,0,-3.46675167478739
2013,3914,6657,0,-13,-25,70,95,0,-15.9657756285103
2013,3982,6657,0,-8,-3,75,78,0,-6.50236535418306
2013,10592,6657,0,-7,4,70,66,1,-7.29536565790052
2013,7721,6692,0,3,15,70,55,1,2.0212718997233
2013,6824,6726,0,-7,13,68,55,1,-3.10631833228048
2013,4624,6824,0,11,8,77,69,1,11.1743006370749
2013,6726,6824,0,7,-13,55,68,0,3.10631833228301
2013,8501,6824,0,8,-17,57,74,0,1.60441396219917
2013,5172,6892,0,13,29,78,49,1,13.8588893676096
2013,10592,7028,0,-1,18,73,55,1,-6.45450492361796
2013,5240,7534,0,9,15,71,56,1,17.6205010869965
2013,2773,7721,0,-8,10,81,71,1,-12.9344294036737
2013,6692,7721,0,-3,-15,55,70,0,-2.02127189972247
2013,3296,8267,0,15,6,64,58,1,24.5733046649164
2013,6142,8501,0,-9,-20,44,64,0,-8.80149425078034
2013,6824,8501,0,-8,17,74,57,1,-1.60441396219691
2013,5105,8535,0,5,2,54,52,1,-2.11859193292736
2013,5743,8535,0,0,-13,54,67,0,-2.99645973728688
2013,1167,8690,0,-8,-6,60,66,0,-8.68034188508249
2013,3846,8690,0,3,-11,50,61,0,6.54947363169096
2013,4901,8690,0,1,-16,39,55,0,-4.92096662354452
2013,5240,8690,0,0,5,61,56,1,0.816906274404577
2013,5541,8690,0,-9,-47,34,81,0,-19.7411183365762
2013,3846,8774,0,8,6,58,52,1,16.7991654360474
2013,5957,8774,0,1,-4,72,76,0,5.70214387808478
2013,5308,9430,0,-5,20,83,63,1,3.0695918794776
2013,1167,9657,0,-7,3,64,61,1,-3.07484080697676
2013,67,9912,0,-7,-46,42,88,0,-6.77473161854649
2013,5240,9912,0,1,25,78,53,1,3.71858404803584
2013,5274,9946,0,11,11,65,54,1,11.2114085505122
2013,6309,10048,0,1,7,78,71,1,3.91517180650821
2013,4177,10252,0,15,7,64,57,1,22.0549377202103
2013,3296,10592,0,8,-6,70,76,0,8.36146927033058
2013,4326,10592,0,-4,-14,58,72,0,-3.21316920522078
2013,4624,10592,0,8,4,72,68,1,11.0952997855492
2013,6657,10592,0,7,-4,66,70,0,7.29536565790004
2013,7028,10592,0,1,-18,55,73,0,6.45450492361722
2013,5342,10692,0,-7,11,57,46,1,-4.82875184172501
2014,2808,174,0,15,12,67,55,1,24.4885936518043
2014,5710,174,0,0,-7,64,71,0,-2.25157488944254
2014,10693,249,0,13,40,75,35,1,17.3219982681225
2014,3297,317,0,-7,-23,61,84,0,-8.08369649797332
2014,7722,317,0,-3,-6,64,70,0,-8.94340790572223
2014,10463,317,0,-15,-9,59,68,0,-24.9462536731355
2014,10693,317,0,-1,1,64,63,1,-5.21494533181608
2014,8911,351,0,3,2,87,85,1,-0.757587654890045
2014,1909,651,0,3,-30,55,85,0,4.40535576877009
2014,6007,651,0,-5,-14,60,74,0,-4.63736070388606
2014,10693,651,0,4,17,69,52,1,3.48719996250167
2014,6825,1076,0,3,19,87,68,1,3.49682285350816
2014,9264,1134,0,0,-12,69,81,0,-7.08540620613324
2014,10593,1134,0,15,27,64,37,1,17.3233596983368
2014,3433,1477,0,-7,4,61,57,1,-4.875931994582
2014,10083,1611,0,15,11,70,59,1,24.3010223950386
2014,7029,1706,0,-1,29,77,48,1,5.39896543820701
2014,2808,1808,0,6,-10,53,63,0,4.79604706487016
2014,3983,1808,0,4,-5,76,81,0,3.16094388141876
2014,4293,1808,0,-1,-6,54,60,0,1.83165423253497
2014,5275,1808,0,3,-6,54,60,0,4.01824880504535
2014,8468,1808,0,-3,-8,81,89,0,-6.78482593601906
2014,10049,1808,0,5,-12,65,77,0,4.11981907065282
2014,651,1909,0,-3,30,85,55,1,-4.40535576876744
2014,9465,1909,0,-11,-10,66,76,0,-16.9113590304344
2014,2808,2111,0,10,10,62,52,1,11.0343723782375
2014,6658,2111,0,5,-1,59,60,0,8.7563289588669
2014,8604,2111,0,1,-10,72,82,0,4.12427073092174
2014,8691,2111,0,8,-2,53,55,0,6.42045394020862
2014,5275,2145,0,9,15,93,78,1,17.164691667627
2014,5140,2369,0,-11,7,78,71,1,-15.4395604808761
2014,4178,2471,0,13,11,80,69,1,21.3568901835068
2014,174,2808,0,-15,-12,55,67,0,-24.4885936517977
2014,1808,2808,0,-6,10,63,53,1,-4.79604706485831
2014,2111,2808,0,-10,-10,52,62,0,-11.0343723782281
2014,7029,2808,0,-8,-16,45,61,0,-3.42788118408089
2014,9431,2808,0,-3,-11,68,79,0,-1.83824990687042
2014,5106,3043,0,1,5,71,66,1,2.43788447318339
2014,317,3297,0,7,23,84,61,1,8.08369649796503
2014,6727,3297,0,-1,-8,77,85,0,3.77024573440161
2014,1477,3433,0,7,-4,57,61,0,4.87593199459078
2014,5275,3433,0,8,7,80,73,1,9.3503292750149
2014,8809,3949,0,0,13,78,65,1,-3.01259010944784
2014,1808,3983,0,-4,5,81,76,1,-3.16094388140903
2014,5924,3983,0,-11,-18,75,93,0,-15.0253186338733
2014,6310,3983,0,-3,-2,83,85,0,-3.76902374722157
2014,2471,4178,0,-13,-11,69,80,0,-21.3568901835032
2014,8604,4178,0,-8,3,60,57,1,-7.45449559394528
2014,4293,4212,0,1,7,56,49,1,5.16027416917939
2014,1808,4293,0,1,6,60,54,1,-1.83165423252828
2014,4212,4293,0,-1,-7,49,56,0,-5.16027416917537
2014,4625,4293,0,4,-5,69,74,0,7.46651222900017
2014,5241,4293,0,6,-3,72,75,0,1.10475678215644
2014,10593,4293,0,7,-2,76,78,0,-1.25499641025446
2014,10693,4293,0,6,-1,73,74,0,1.11079755050529
2014,4293,4625,0,-4,5,74,69,1,-7.46651222899872
2014,4834,4625,0,-9,-7,64,71,0,-19.7088711600054
2014,8502,4625,0,-1,-15,51,66,0,-13.5901598794872
2014,4625,4834,0,9,7,71,64,1,19.7088711600075
2014,8809,5004,0,-5,19,86,67,1,5.15110811431683
2014,3043,5106,0,-1,-5,66,71,0,-2.4378844731891
2014,10083,5106,0,7,18,78,60,1,5.15748157030522
2014,2369,5140,0,11,-7,71,78,0,15.4395604808756
2014,8809,5140,0,3,20,83,63,1,11.5461839350954
2014,4293,5241,0,-6,3,75,72,1,-1.10475678215563
2014,8809,5241,0,-9,-2,71,73,0,-2.51378012841187
2014,8911,5241,0,-5,-14,65,79,0,-5.67209565815986
2014,10716,5241,0,-13,-17,40,57,0,-23.4510029799314
2014,1808,5275,0,-3,6,60,54,1,-4.01824880504306
2014,2145,5275,0,-9,-15,78,93,0,-17.1646916676315
2014,3433,5275,0,-8,-7,73,80,0,-9.35032927501935
2014,10083,5275,0,3,-2,59,61,0,-1.51432701923252
2014,174,5710,0,0,7,71,64,1,2.25157488943957
2014,6693,5805,0,7,-5,75,80,0,9.10351319931103
2014,7722,5805,0,8,19,63,44,1,8.56701413636553
2014,3983,5924,0,11,18,93,75,1,15.0253186338755
2014,8502,5958,0,7,3,83,80,1,3.07471121411626
2014,10815,5958,0,0,-15,59,74,0,4.38716416977766
2014,651,6007,0,5,14,74,60,1,4.63736070389065
2014,8604,6109,0,-3,5,58,53,1,0.622441389671792
2014,7722,6143,0,9,4,73,69,1,8.79681428322688
2014,3983,6310,0,3,2,85,83,1,3.76902374723188
2014,7196,6310,0,-5,-2,77,79,0,-3.39558980587178
2014,2111,6658,0,-5,1,60,59,1,-8.75632895886754
2014,5805,6693,0,-7,5,80,75,1,-9.10351319930928
2014,3297,6727,0,1,8,85,77,1,-3.77024573440353
2014,1076,6825,0,-3,-19,68,87,0,-3.49682285349599
2014,10693,6825,0,5,8,85,77,1,2.92043803419762
2014,1706,7029,0,1,-29,48,77,0,-5.3989654382144
2014,2808,7029,0,8,16,61,45,1,3.42788118409337
2014,6310,7196,0,5,2,79,77,1,3.39558980587433
2014,317,7722,0,3,6,70,64,1,8.94340790571773
2014,5805,7722,0,-8,-19,44,63,0,-8.56701413636319
2014,6143,7722,0,-9,-4,69,73,0,-8.79681428322487
2014,9431,8020,0,8,17,77,60,1,14.293472572287
2014,9913,8020,0,7,-2,75,77,0,10.3089730014338
2014,1808,8468,0,3,8,89,81,1,6.78482593602191
2014,4625,8502,0,1,15,66,51,1,13.5901598794862
2014,5958,8502,0,-7,-3,80,83,0,-3.07471121411936
2014,2111,8604,0,-1,10,82,72,1,-4.12427073092435
2014,4178,8604,0,8,-3,57,60,0,7.45449559395039
2014,6109,8604,0,3,-5,53,58,0,-0.622441389674677
2014,2111,8691,0,-8,2,55,53,1,-6.42045394020737
2014,10287,8691,0,-11,-24,53,77,0,-13.6489650997086
2014,3949,8809,0,0,-13,65,78,0,3.01259010944664
2014,5004,8809,0,5,-19,67,86,0,-5.15110811431556
2014,5140,8809,0,-3,-20,63,83,0,-11.5461839350886
2014,5241,8809,0,9,2,73,71,1,2.5137801284109
2014,351,8911,0,-3,-2,85,87,0,0.75758765487997
2014,5241,8911,0,5,14,79,65,1,5.67209565815927
2014,9431,9196,0,9,17,76,59,1,12.3211634221513
2014,1134,9264,0,0,12,81,69,1,7.08540620613619
2014,2808,9431,0,3,11,79,68,1,1.83824990687847
2014,8020,9431,0,-8,-17,60,77,0,-14.2934725722883
2014,9196,9431,0,-9,-17,59,76,0,-12.3211634221534
2014,1909,9465,0,11,10,76,66,1,16.9113590304333
2014,8020,9913,0,-7,2,77,75,1,-10.3089730014347
2014,1808,10049,0,-5,12,77,65,1,-4.11981907064941
2014,10559,10049,0,-13,-20,53,73,0,-21.3831349316068
2014,1611,10083,0,-15,-11,59,70,0,-24.3010223950348
2014,5106,10083,0,-7,-18,60,78,0,-5.15748157030775
2014,5275,10083,0,-3,2,61,59,1,1.51432701923221
2014,8691,10287,0,11,24,77,53,1,13.6489650997086
2014,317,10463,0,15,9,68,59,1,24.9462536731304
2014,10049,10559,0,13,20,73,53,1,21.3831349316085
2014,1134,10593,0,-15,-27,37,64,0,-17.3233596983332
2014,4293,10593,0,-7,2,78,76,1,1.25499641025957
2014,249,10693,0,-13,-40,35,75,0,-17.3219982681203
2014,317,10693,0,1,-1,63,64,0,5.21494533180731
2014,651,10693,0,-4,-17,52,69,0,-3.48719996249841
2014,4293,10693,0,-6,1,74,73,1,-1.11079755050211
2014,6825,10693,0,-5,-8,77,85,0,-2.9204380342003
2014,5241,10716,0,13,17,57,40,1,23.4510029799291
2014,5958,10815,0,0,15,74,59,1,-4.38716416978145
2015,6694,175,0,11,9,69,60,1,20.3549559801647
2015,6659,318,0,-8,-15,58,73,0,-4.37567912776951
2015,9265,318,0,-13,-21,72,93,0,-30.7920457658872
2015,10694,318,0,1,7,85,78,1,0.192384971513903
2015,10816,318,0,-4,-8,60,68,0,-9.5298982115354
2015,6311,440,0,1,9,87,78,1,6.57374976781497
2015,10717,440,0,-7,-3,53,56,0,-12.3594809420915
2015,3230,652,0,-11,1,57,56,1,-14.0432431091288
2015,10084,671,0,13,12,79,67,1,22.6850904905864
2015,2112,760,0,0,1,56,55,1,0.47819502225266
2015,10498,1009,0,7,6,68,62,1,7.97558445311508
2015,6572,1043,0,3,3,67,64,1,2.71765050377189
2015,8912,1043,0,-5,-8,48,56,0,0.341687982607375
2015,5344,1077,0,0,4,94,90,1,-2.40689781864235
2015,4294,1478,0,7,13,64,51,1,18.8097197934566
2015,7231,1478,0,-1,-1,65,66,0,2.74654612060397
2015,10694,1612,0,15,14,86,72,1,26.4512550076234
2015,3950,2078,0,3,31,83,52,1,2.67364881854803
2015,760,2112,0,0,-1,55,56,0,-0.478195022271397
2015,6694,2112,0,8,6,72,66,1,9.09895198405353
2015,7197,2112,0,5,-13,53,66,0,3.65099190772228
2015,3298,2370,0,-1,-14,52,66,0,-2.24443346783356
2015,5276,2370,0,-6,-20,61,81,0,-6.61723369344887
2015,7455,2370,0,-15,-29,56,85,0,-27.1207780886843
2015,7723,2370,0,-7,-19,49,68,0,-12.1226435370661
2015,9795,2370,0,-4,-6,57,63,0,-2.84199588053699
2015,10694,2370,0,0,-5,63,68,0,0.852650785385997
2015,3162,2540,0,9,10,84,74,1,15.4465752980975
2015,2540,3162,0,-9,-10,74,84,0,-15.4465752980807
2015,9795,3162,0,-1,11,75,64,1,5.24348947886504
2015,5276,3196,0,3,7,70,63,1,4.67168868144031
2015,652,3230,0,11,-1,56,57,0,14.0432431091132
2015,10816,3230,0,8,8,75,67,1,10.3123123790141
2015,2370,3298,0,1,14,66,52,1,2.24443346784406
2015,3950,3298,0,-5,-19,68,87,0,-6.07960809726794
2015,5806,3298,0,-13,-10,76,86,0,-24.0790061607704
2015,9432,3298,0,-9,-12,62,74,0,-9.68394387445871
2015,4294,3360,0,15,23,79,56,1,38.5107535539651
2015,4835,3360,0,0,-10,64,74,0,8.42925174547205
2015,6311,3434,0,9,2,67,65,1,17.113959819993
2015,10594,3848,0,3,5,81,76,1,1.78195446286832
2015,2078,3950,0,-3,-31,52,83,0,-2.6736488185522
2015,3298,3950,0,5,19,87,68,1,6.07960809726423
2015,9299,3984,0,-11,1,60,59,1,-17.3788784536697
2015,6144,4179,0,-13,-19,56,75,0,-15.6775669772428
2015,10594,4179,0,-5,13,78,65,1,-4.39565192791978
2015,1478,4294,0,-7,-13,51,64,0,-18.809719793461
2015,3360,4294,0,-15,-23,56,79,0,-38.5107535539561
2015,6572,4294,0,-2,-2,66,68,0,-10.0270379098605
2015,10498,4294,0,-4,-39,39,78,0,-13.057806302485
2015,10694,4294,0,0,7,71,64,1,-4.45200433124998
2015,10050,4362,0,15,41,93,52,1,25.9831287056096
2015,5276,4626,0,-3,6,76,70,1,-1.12345026699543
2015,5959,4626,0,-4,-10,65,75,0,-4.3937508809051
2015,6470,4626,0,-1,-13,53,66,0,-6.24978445707639
2015,9347,4626,0,-9,-2,55,57,0,-15.1419891456905
2015,5959,4762,0,1,1,66,65,1,2.57955855991905
2015,3360,4835,0,0,10,74,64,1,-8.42925174546673
2015,9948,4971,0,-9,-3,62,65,0,-7.75186327300878
2015,10498,4971,0,-1,10,69,59,1,2.30928333522028
2015,2370,5276,0,6,20,81,61,1,6.61723369345578
2015,3196,5276,0,-3,-7,63,70,0,-4.67168868143569
2015,4626,5276,0,3,-6,70,76,0,1.12345026698835
2015,6694,5276,0,4,-4,58,62,0,2.39386961163179
2015,10084,5276,0,5,-6,54,60,0,5.09709023326466
2015,1077,5344,0,0,-4,90,94,0,2.40689781864311
2015,10816,5344,0,5,19,76,57,1,3.38900731665971
2015,3298,5806,0,13,10,86,76,1,24.0790061607719
2015,4626,5959,0,4,10,75,65,1,4.3937508808993
2015,4762,5959,0,-1,-1,65,66,0,-2.57955855992309
2015,10050,5959,0,7,-3,68,71,0,9.06553736614126
2015,4179,6144,0,13,19,75,56,1,15.6775669772456
2015,440,6311,0,-1,-9,78,87,0,-6.5737497678252
2015,3434,6311,0,-9,-2,65,67,0,-17.1139598199923
2015,10694,6311,0,3,7,79,72,1,3.67162585583538
2015,7455,6334,0,0,4,81,77,1,-2.63900612608173
2015,6572,6402,0,11,4,69,65,1,17.4361295021262
2015,4626,6470,0,1,13,66,53,1,6.24978445707266
2015,10782,6470,0,-7,-17,54,71,0,-8.01770359185343
2015,1043,6572,0,-3,-3,64,67,0,-2.71765050377719
2015,4294,6572,0,2,2,68,66,1,10.0270379098648
2015,6402,6572,0,-11,-4,65,69,0,-17.4361295021269
2015,10594,6572,0,-4,-11,70,81,0,-4.25942009084932
2015,318,6659,0,8,15,73,58,1,4.37567912776814
2015,9914,6659,0,3,-3,72,75,0,-7.51136322888221
2015,175,6694,0,-11,-9,60,69,0,-20.3549559801611
2015,2112,6694,0,-8,-6,66,72,0,-9.09895198406411
2015,5276,6694,0,-4,4,62,58,1,-2.39386961163722
2015,6826,6728,0,1,6,79,73,1,-2.64030507036048
2015,6728,6826,0,-1,-6,73,79,0,2.64030507036462
2015,10694,6826,0,7,7,72,65,1,13.642650520951
2015,2112,7197,0,-5,13,66,53,1,-3.65099190772814
2015,1478,7231,0,1,1,66,65,1,-2.74654612061216
2015,2370,7455,0,15,29,85,56,1,27.120778088694
2015,6334,7455,0,0,-4,77,81,0,2.63900612608071
2015,2370,7723,0,7,19,68,49,1,12.1226435370736
2015,8435,7723,0,-1,-12,64,76,0,0.474579930808975
2015,9795,8021,0,7,7,57,50,1,12.59561722137
2015,9432,8089,0,-5,1,60,59,1,-1.02117005988644
2015,7723,8435,0,1,12,76,64,1,-0.474579930811501
2015,1043,8912,0,5,8,56,48,1,-0.341687982611461
2015,318,9265,0,13,21,93,72,1,30.7920457658893
2015,3984,9299,0,11,-1,59,60,0,17.3788784536676
2015,9432,9299,0,3,17,92,75,1,10.428730232684
2015,4626,9347,0,9,2,57,55,1,15.1419891456857
2015,3298,9432,0,9,12,74,62,1,9.68394387446103
2015,8089,9432,0,5,-1,59,60,0,1.02117005988813
2015,9299,9432,0,-3,-17,75,92,0,-10.4287302326834
2015,2370,9795,0,4,6,63,57,1,2.84199588054833
2015,3162,9795,0,1,-11,64,75,0,-5.24348947885443
2015,8021,9795,0,-7,-7,50,57,0,-12.595617221366
2015,6659,9914,0,-3,3,75,72,1,7.51136322888146
2015,4971,9948,0,9,3,65,62,1,7.75186327300501
2015,4362,10050,0,-15,-41,52,93,0,-25.9831287056163
2015,5959,10050,0,-7,3,71,68,1,-9.06553736614326
2015,671,10084,0,-13,-12,67,79,0,-22.6850904905899
2015,5276,10084,0,-5,6,60,54,1,-5.09709023326735
2015,1009,10498,0,-7,-6,62,68,0,-7.97558445311421
2015,4294,10498,0,4,39,78,39,1,13.0578063024909
2015,4971,10498,0,1,-10,59,69,0,-2.309283335224
2015,3848,10594,0,-3,-5,76,81,0,-1.78195446287384
2015,4179,10594,0,5,-13,65,78,0,4.39565192791861
2015,6572,10594,0,4,11,81,70,1,4.25942009084778
2015,318,10694,0,-1,-7,78,85,0,-0.192384971512702
2015,1612,10694,0,-15,-14,72,86,0,-26.4512550076238
2015,2370,10694,0,0,5,68,63,1,-0.852650785375658
2015,4294,10694,0,0,-7,64,71,0,4.45200433125692
2015,6311,10694,0,-3,-7,72,79,0,-3.67162585583138
2015,6826,10694,0,-7,-7,65,72,0,-13.6426505209492
2015,440,10717,0,7,3,56,53,1,12.3594809420778
2015,6470,10782,0,7,17,71,54,1,8.01770359185395
2015,318,10816,0,4,8,68,60,1,9.52989821153624
2015,3230,10816,0,-8,-8,67,75,0,-10.3123123790116
2015,5344,10816,0,-5,-19,57,76,0,-3.38900731665946
2016,10595,319,0,-5,10,65,55,1,-2.87256504831739
2016,3985,387,0,8,17,78,61,1,10.5816857310841
2016,7232,387,0,7,-2,83,85,0,13.9908915514069
2016,4180,585,0,15,26,105,79,1,30.3239556845209
2016,10851,653,0,-7,4,79,75,1,-8.42724801613258
2016,5175,1010,0,11,7,79,72,1,18.0410303372684
2016,9015,1044,0,1,-10,61,71,0,-3.01801984495167
2016,10085,1044,0,8,8,77,69,1,5.83599885491913
2016,3469,1170,0,-9,11,77,66,1,-7.45764222290156
2016,3849,1411,0,7,25,99,74,1,15.8976533194199
2016,8470,1479,0,1,2,78,76,1,-3.66212646050209
2016,1810,1708,0,-1,7,74,67,1,3.52555847648617
2016,1708,1810,0,1,-7,67,74,0,-3.52555847648612
2016,4180,1810,0,8,12,73,61,1,8.27933154133132
2016,6695,1922,0,13,14,82,68,1,18.1778566082264
2016,8693,2113,0,-3,19,70,51,1,1.47707511920989
2016,6827,2371,0,3,14,82,68,1,-1.92357200938532
2016,9626,2371,0,-9,-8,85,93,0,-13.6977664564089
2016,10851,2371,0,-8,-7,64,71,0,-11.4426043263947
2016,2776,2706,0,0,31,96,65,1,8.30329075564297
2016,2706,2776,0,0,-31,65,96,0,-8.3032907556419
2016,6312,2776,0,15,16,83,67,1,24.7321059417762
2016,9796,2977,0,11,11,80,69,1,11.2922496755791
2016,7990,3299,0,5,-16,52,68,0,-1.49918474877886
2016,8693,3299,0,1,3,63,60,1,-2.69511239172066
2016,9796,3299,0,8,-23,59,82,0,0.28912852545238
2016,10085,3361,0,15,36,81,45,1,30.2846581577876
2016,1170,3469,0,9,-11,66,77,0,7.45764222290109
2016,4972,3469,0,8,13,73,60,1,8.4829974857812
2016,6827,3556,0,15,39,91,52,1,28.9985615968943
2016,8270,3556,0,0,-4,55,59,0,3.66511281493548
2016,1411,3849,0,-7,-25,74,99,0,-15.8976533194219
2016,4295,3849,0,1,-6,67,73,0,0.696545093073183
2016,6312,3849,0,4,15,101,86,1,3.22719085563972
2016,3985,3917,0,9,13,94,81,1,13.6183652131917
2016,8777,3951,0,-3,-2,70,72,0,-10.4095890387769
2016,10051,3951,0,5,19,87,68,1,3.59896357270604
2016,387,3985,0,-8,-17,61,78,0,-10.5816857310743
2016,3917,3985,0,-9,-13,81,94,0,-13.6183652131886
2016,10085,3985,0,3,13,84,71,1,4.45544862188165
2016,585,4180,0,-15,-26,79,105,0,-30.3239556845229
2016,1810,4180,0,-8,-12,61,73,0,-8.27933154133551
2016,4972,4180,0,-4,-16,63,79,0,-7.02206873935432
2016,10051,4180,0,-1,5,64,59,1,-2.76851036765544
2016,3849,4295,0,-1,6,73,67,1,-0.696545093065552
2016,8659,4295,0,-9,-28,57,85,0,-16.2642529519837
2016,3469,4972,0,-8,-13,60,73,0,-8.48299748578261
2016,4180,4972,0,4,16,79,63,1,7.0220687393477
2016,7537,4972,0,-7,-5,74,79,0,-11.9107287638864
2016,1010,5175,0,-11,-7,72,79,0,-18.0410303372707
2016,10051,5175,0,1,23,92,69,1,2.32586599095266
2016,10595,5175,0,-8,-8,57,65,0,-2.70358989842925
2016,6573,5243,0,5,7,70,63,1,-0.102989627077068
2016,9198,5243,0,0,-5,62,67,0,-4.28674646039181
2016,5746,5277,0,-13,9,90,81,1,-21.5436520113127
2016,5277,5746,0,13,-9,81,90,0,21.5436520113123
2016,8693,5746,0,5,25,75,50,1,11.3092967576729
2016,2776,6312,0,-15,-16,67,83,0,-24.7321059417749
2016,3849,6312,0,-4,-15,86,101,0,-3.22719085563112
2016,6573,6312,0,-5,-14,74,88,0,-8.78372645819293
2016,7198,6312,0,-8,-19,66,85,0,-11.1686492834949
2016,8693,6312,0,-9,-17,66,83,0,-9.46865317360254
2016,10051,6312,0,-1,3,77,74,1,-1.39341018334136
2016,8913,6471,0,5,-3,72,75,0,7.53482290585053
2016,8947,6471,0,8,4,92,88,1,10.8687601819923
2016,5243,6573,0,-5,-7,63,70,0,0.102989627071022
2016,6312,6573,0,5,14,88,74,1,8.78372645819229
2016,8022,6573,0,-8,-1,75,76,0,-5.80221021421672
2016,10695,6573,0,-1,-5,56,61,0,-0.766696693150831
2016,1922,6695,0,-13,-14,68,82,0,-18.1778566082294
2016,6827,6695,0,1,-12,68,80,0,-2.77185389159369
2016,8947,6695,0,-1,-14,63,77,0,-1.81721453481698
2016,9915,6695,0,-8,-4,81,85,0,-7.17567181522291
2016,10051,6695,0,0,44,95,51,1,0.736997849789489
2016,2371,6827,0,-3,-14,68,82,0,1.92357200937863
2016,3556,6827,0,-15,-39,52,91,0,-28.9985615968962
2016,6695,6827,0,-1,12,80,68,1,2.77185389159025
2016,8470,6827,0,-7,-5,64,69,0,-6.21767279768324
2016,9915,6861,0,-3,8,75,67,1,2.74233005692129
2016,10695,7031,0,3,4,47,43,1,-2.22195249706638
2016,6312,7198,0,8,19,85,66,1,11.1686492834973
2016,9694,7198,0,1,-1,69,70,0,2.15048017870493
2016,387,7232,0,-7,2,85,83,1,-13.9908915513991
2016,4972,7537,0,7,5,79,74,1,11.9107287638857
2016,3299,7990,0,-5,16,68,52,1,1.49918474877055
2016,6573,8022,0,8,1,76,75,1,5.80221021421309
2016,10499,8022,0,11,-14,56,70,0,14.4441951777169
2016,3556,8270,0,0,4,59,55,1,-3.66511281493627
2016,1479,8470,0,-1,-2,76,78,0,3.66212646049706
2016,6827,8470,0,7,5,69,64,1,6.21767279768268
2016,4295,8659,0,9,28,85,57,1,16.2642529519856
2016,2113,8693,0,3,-19,51,70,0,-1.47707511920881
2016,3299,8693,0,-1,-3,60,63,0,2.6951123917134
2016,5746,8693,0,-5,-25,50,75,0,-11.3092967576717
2016,6312,8693,0,9,17,83,66,1,9.46865317360458
2016,10085,8693,0,9,-6,62,68,0,8.48847214321262
2016,3951,8777,0,3,2,72,70,1,10.4095890387811
2016,6471,8913,0,-5,3,75,72,1,-7.53482290585286
2016,6471,8947,0,-8,-4,88,92,0,-10.8687601819958
2016,6695,8947,0,1,14,77,63,1,1.81721453481221
2016,10533,8947,0,-11,-27,65,92,0,-17.6584359261286
2016,1044,9015,0,-1,10,71,61,1,3.01801984496118
2016,5243,9198,0,0,5,67,62,1,4.28674646038796
2016,10051,9565,0,13,30,86,56,1,20.0052841570441
2016,2371,9626,0,9,8,93,85,1,13.6977664564023
2016,7198,9694,0,-1,1,70,69,1,-2.15048017870561
2016,2977,9796,0,-11,-11,69,80,0,-11.2922496755825
2016,3299,9796,0,-8,23,82,59,1,-0.289128525462093
2016,6695,9915,0,8,4,85,81,1,7.17567181521949
2016,6861,9915,0,3,-8,67,75,0,-2.74233005691938
2016,10595,9983,0,0,20,70,50,1,-1.63670736099871
2016,3951,10051,0,-5,-19,68,87,0,-3.59896357270117
2016,4180,10051,0,1,-5,59,64,0,2.768510367652
2016,5175,10051,0,-1,-23,69,92,0,-2.32586599095718
2016,6312,10051,0,1,-3,74,77,0,1.39341018334411
2016,6695,10051,0,0,-44,51,95,0,-0.736997849792097
2016,9565,10051,0,-13,-30,56,86,0,-20.0052841570438
2016,1044,10085,0,-8,-8,69,77,0,-5.83599885491088
2016,3361,10085,0,-15,-36,45,81,0,-30.2846581577894
2016,3985,10085,0,-3,-13,71,84,0,-4.45544862187802
2016,8693,10085,0,-9,6,68,62,1,-8.48847214321269
2016,10817,10465,0,13,18,71,53,1,18.4326796829825
2016,8022,10499,0,-11,14,70,56,1,-14.444195177719
2016,8947,10533,0,11,27,92,65,1,17.6584359261282
2016,319,10595,0,5,-10,55,65,0,2.87256504832597
2016,5175,10595,0,8,8,65,57,1,2.70358989842395
2016,9983,10595,0,0,-20,50,70,0,1.63670736099872
2016,6573,10695,0,1,5,61,56,1,0.766696693149584
2016,7031,10695,0,-3,-4,43,47,0,2.22195249706903
2016,10817,10695,0,5,-3,63,66,0,5.24658219548669
2016,10465,10817,0,-13,-18,53,71,0,-18.4326796829808
2016,10695,10817,0,-5,3,66,63,1,-5.24658219548404
2016,653,10851,0,7,-4,75,79,0,8.42724801612525
2016,2371,10851,0,8,7,71,64,1,11.4426043263887
2017,6323,320,0,-13,-18,82,100,0,-20.2653538401553
2017,8539,320,0,-5,-9,60,69,0,-1.26018596362005
2017,10818,320,0,-9,2,73,71,1,-3.95968345530908
2017,6313,442,0,7,7,72,65,1,11.2039714392946
2017,7991,442,0,-1,-6,71,77,0,-1.28916824720292
2017,6146,654,0,-11,-18,73,91,0,-16.009051185373
2017,8159,654,0,-4,20,70,50,1,-5.00741458912065
2017,9695,654,0,-8,-4,78,82,0,-9.38728056053606
2017,10500,984,0,9,6,86,80,1,19.2136859898471
2017,5747,1045,0,-8,-9,65,74,0,-8.80761183622307
2017,6313,1045,0,3,12,92,80,1,6.75154138186694
2017,10662,1045,0,-9,-12,64,76,0,-16.9855486475055
2017,4215,1480,0,-5,-14,61,75,0,-3.58258559663867
2017,9434,1480,0,3,12,79,67,1,2.20740497987209
2017,7321,1912,0,-5,12,84,72,1,-5.58794043312942
2017,10596,2114,0,-3,6,64,58,1,8.3653564972313
2017,8159,2372,0,-5,7,88,81,1,-6.91691144839086
2017,9135,2372,0,-13,-22,65,87,0,-22.7601386012706
2017,2811,2639,0,9,15,80,65,1,14.5958625116127
2017,2910,2777,0,11,6,86,80,1,18.5707401688465
2017,2639,2811,0,-9,-15,65,80,0,-14.5958625116035
2017,8159,2811,0,-3,7,77,70,1,-6.67483655335275
2017,10086,2811,0,-1,-26,39,65,0,0.0727938180986527
2017,10696,2811,0,-4,-1,83,84,0,-2.82152440041861
2017,2777,2910,0,-11,-6,80,86,0,-18.5707401688354
2017,10818,2910,0,-8,25,91,66,1,-6.24430081852136
2017,6313,3300,0,0,6,71,65,1,-0.663411191998094
2017,6506,3300,0,-7,-6,73,79,0,-11.5733562856413
2017,7538,3300,0,-15,-20,46,66,0,-28.1434672005557
2017,8159,3300,0,-6,-4,73,77,0,-10.2151543334878
2017,10500,3300,0,-3,-3,58,61,0,-0.963663355781868
2017,10818,3300,0,-10,-24,59,83,0,-11.3074310680724
2017,6828,3918,0,11,16,93,77,1,19.6718893736136
2017,6044,3986,0,-7,-11,73,84,0,-10.0902182166544
2017,7233,3986,0,1,4,80,76,1,0.644221688150289
2017,4628,4113,0,13,15,78,63,1,26.7774779641334
2017,5278,4181,0,-8,-20,70,90,0,-9.00368595578174
2017,6828,4181,0,-2,14,74,60,1,-1.95173738120725
2017,7233,4181,0,-3,-32,66,98,0,-1.36757122468231
2017,9315,4181,0,-15,-38,62,100,0,-27.7371380599907
2017,1480,4215,0,5,14,75,61,1,3.58258559663399
2017,10364,4215,0,0,-7,88,95,0,-0.0814867811113729
2017,9434,4262,0,11,17,97,80,1,19.7935149430268
2017,5848,4296,0,-13,-9,70,79,0,-24.6947373845044
2017,6313,4296,0,1,2,75,73,1,0.866640237750673
2017,9434,4296,0,-1,-11,75,86,0,-3.37054601460261
2017,10596,4296,0,-8,-3,62,65,0,-2.70782875410057
2017,4113,4628,0,-13,-15,63,78,0,-26.7774779641339
2017,5244,4628,0,-5,4,73,69,1,-4.9438543736144
2017,8159,4905,0,3,20,93,73,1,-0.699345413791612
2017,10818,4973,0,-5,11,76,65,1,1.12591353790707
2017,5278,5176,0,-1,20,78,58,1,-2.06354980542224
2017,4628,5244,0,5,-4,69,73,0,4.94385437361604
2017,6730,5244,0,-3,-1,91,92,0,0.409104837899964
2017,6828,5244,0,4,1,69,68,1,1.9687362954056
2017,4181,5278,0,8,20,90,70,1,9.00368595578402
2017,5176,5278,0,1,-20,58,78,0,2.06354980541767
2017,5747,5312,0,-7,9,81,72,1,-5.71402592847068
2017,6178,5713,0,0,-1,66,67,0,0.324077383048245
2017,10052,5713,0,15,20,76,56,1,29.1612873969608
2017,1045,5747,0,8,9,74,65,1,8.80761183622088
2017,5312,5747,0,7,-9,72,81,0,5.71402592846651
2017,4296,5848,0,13,9,79,70,1,24.6947373844999
2017,9315,5927,0,0,4,67,63,1,-2.37589096911158
2017,3986,6044,0,7,11,84,73,1,10.0902182166515
2017,654,6146,0,11,18,91,73,1,16.0090511853775
2017,5713,6178,0,0,1,67,66,1,-0.324077383047139
2017,442,6313,0,-7,-7,65,72,0,-11.2039714393013
2017,1045,6313,0,-3,-12,80,92,0,-6.75154138186967
2017,3300,6313,0,0,-6,65,71,0,0.663411191999259
2017,4296,6313,0,-1,-2,73,75,0,-0.866640237758062
2017,6828,6313,0,-2,-1,76,77,0,-4.33753950639299
2017,9267,6313,0,-15,-39,64,103,0,-31.0518307133982
2017,320,6323,0,13,18,100,82,1,20.2653538401492
2017,3300,6506,0,7,6,79,73,1,11.5733562856481
2017,9984,6506,0,-1,-2,66,68,0,-0.378473076278866
2017,7165,6574,0,-7,-2,58,60,0,-12.4734813312259
2017,10500,6574,0,1,12,83,71,1,5.88303892941419
2017,5244,6730,0,3,1,92,91,1,-0.409104837898678
2017,3918,6828,0,-11,-16,77,93,0,-19.6718893736145
2017,4181,6828,0,2,-14,60,74,0,1.9517373812088
2017,5244,6828,0,-4,-1,68,69,0,-1.96873629540733
2017,6313,6828,0,2,1,77,76,1,4.33753950638949
2017,7321,6828,0,-8,-3,72,75,0,-8.22873561811983
2017,6574,7165,0,7,2,60,58,1,12.4734813312276
2017,9695,7199,0,0,4,75,71,1,-0.641441152256839
2017,3986,7233,0,-1,-4,76,80,0,-0.644221688155383
2017,4181,7233,0,3,32,98,66,1,1.36757122468242
2017,10018,7233,0,-9,-10,70,80,0,-14.6119361984274
2017,1912,7321,0,5,-12,72,84,0,5.58794043312453
2017,6828,7321,0,8,3,75,72,1,8.22873561811997
2017,3300,7538,0,15,20,66,46,1,28.14346720056
2017,442,7991,0,1,6,77,71,1,1.28916824719798
2017,9695,8091,0,-5,1,66,65,1,-7.92683750929297
2017,654,8159,0,4,-20,50,70,0,5.00741458913102
2017,2372,8159,0,5,-7,81,88,0,6.91691144838868
2017,2811,8159,0,3,-7,70,77,0,6.67483655336119
2017,3300,8159,0,6,4,77,73,1,10.215154333495
2017,4905,8159,0,-3,-20,73,93,0,0.699345413792134
2017,320,8539,0,5,9,69,60,1,1.26018596361217
2017,9916,8539,0,-3,-8,77,85,0,-5.23403459832697
2017,2372,9135,0,13,22,87,65,1,22.7601386012649
2017,6313,9267,0,15,39,103,64,1,31.0518307133953
2017,4181,9315,0,15,38,100,62,1,27.7371380599915
2017,5927,9315,0,0,-4,63,67,0,2.37589096911145
2017,1480,9434,0,-3,-12,67,79,0,-2.20740497987865
2017,4262,9434,0,-11,-17,80,97,0,-19.7935149430288
2017,4296,9434,0,1,11,86,75,1,3.37054601459601
2017,10086,9627,0,7,5,76,71,1,14.275967385841
2017,654,9695,0,8,4,82,78,1,9.38728056054223
2017,7199,9695,0,0,-4,71,75,0,0.64144115225799
2017,8091,9695,0,5,-1,65,66,0,7.92683750929582
2017,8539,9916,0,3,8,85,77,1,5.23403459832726
2017,6506,9984,0,1,2,68,66,1,0.378473076281402
2017,7233,10018,0,9,10,80,70,1,14.6119361984256
2017,5713,10052,0,-15,-20,56,76,0,-29.1612873969605
2017,10696,10052,0,-7,3,65,62,1,-5.36796568023094
2017,2811,10086,0,1,26,65,39,1,-0.0727938180949579
2017,9627,10086,0,-7,-5,71,76,0,-14.275967385843
2017,10696,10120,0,1,10,84,74,1,5.84031622913771
2017,4215,10364,0,0,7,95,88,1,0.0814867811122149
2017,984,10500,0,-9,-6,80,86,0,-19.2136859898446
2017,3300,10500,0,3,3,61,58,1,0.963663355786011
2017,6574,10500,0,-1,-12,71,83,0,-5.88303892941359
2017,2114,10596,0,3,-6,58,64,0,-8.3653564972295
2017,4296,10596,0,8,3,65,62,1,2.70782875409483
2017,1045,10662,0,9,12,76,64,1,16.9855486475054
2017,2811,10696,0,4,1,84,83,1,2.8215244004238
2017,10052,10696,0,7,-3,62,65,0,5.367965680231
2017,10120,10696,0,-1,-10,74,84,0,-5.84031622913694
2017,320,10818,0,9,-2,71,73,0,3.95968345530094
2017,2910,10818,0,8,-25,66,91,0,6.24430081853005
2017,3300,10818,0,10,24,83,59,1,11.3074310680768
2017,4973,10818,0,5,-11,65,76,0,-1.12591353790556
